countyFIPS,County Name,State,Total population,Males,Females,Sex ratio(males per 100 females),Under 5years,5-9years,10-14years,15-19years,20-24years,25-34years,35-44years,45-54years,55-59years,60-64years,65-74years,75-84years,85years and over,Median age(years),Under 18years,18years and over,18years and over Male,18years and over Female,Sex ratio(18years and over),White population,Black population,Asian population,Voting population,Voting population(Male),Voting population(Female)
1001,Autauga County,AL,55380,26934,28446,94.7,3217,3814,3600,3812,3570,7056,7306,7736,4247,2739,4818,2581,884,38.2,13205,42175,20164,22011,91.6,42527,10538,573,41647,19823,21824
1003,Baldwin County,AL,212830,103496,109334,94.7,11689,12058,14262,12831,10878,23942,25834,28412,15081,15312,25739,12744,4048,43.0,46235,166595,79948,86647,92.3,183471,19718,1969,162883,77958,84925
1005,Barbour County,AL,25361,13421,11940,112.4,1349,1622,1422,1412,1592,3642,3038,3310,1628,1636,2844,1461,405,40.4,5307,20054,10760,9294,115.8,11869,12066,134,19728,10529,9199
1007,Bibb County,AL,22493,12150,10343,117.5,1315,1219,1132,1400,1259,3276,2910,3519,1415,1464,2098,1044,442,40.9,4631,17862,9547,8315,114.8,17272,5014,27,17662,9469,8193
1009,Blount County,AL,57681,28495,29186,97.6,3432,3590,4034,3622,3212,6839,7263,7699,3855,3809,6111,3160,1055,40.7,13389,44292,21668,22624,95.8,55062,928,212,42722,20833,21889
1011,Bullock County,AL,10248,5571,4677,119.1,542,638,554,814,599,1271,1384,1361,675,770,1020,449,171,40.2,2128,8120,4480,3640,123.1,2244,7666,50,8120,4480,3640
1013,Butler County,AL,19828,9081,10747,84.5,1149,1292,1203,1272,1093,2339,2529,2227,1416,1408,2288,1087,525,40.8,4455,15373,6876,8497,80.9,10280,9001,69,15308,6843,8465
1015,Calhoun County,AL,114618,55141,59477,92.7,6608,6619,7149,7747,7387,15129,13694,14594,8016,7937,11727,5951,2060,39.6,24952,89666,42341,47325,89.5,84439,23830,1014,88204,41767,46437
1017,Chambers County,AL,33660,16089,17571,91.6,2043,1795,2026,1816,2191,4128,3836,4551,2630,2174,3958,1859,653,42.0,7065,26595,12577,14018,89.7,19423,13316,376,26171,12301,13870
1019,Cherokee County,AL,25903,12777,13126,97.3,1187,1454,1489,1598,1301,2495,2871,3688,2019,1990,3511,1787,513,46.5,5245,20658,10163,10495,96.8,24052,1191,64,20578,10102,10476
1021,Chilton County,AL,44055,21459,22596,95.0,2759,3225,2657,2894,2474,5782,5874,5582,2948,2808,4152,2288,612,38.7,10635,33420,16196,17224,94.0,36835,4041,195,32309,15631,16678
1023,Choctaw County,AL,12925,6145,6780,90.6,679,628,799,844,646,1276,1419,1739,1017,956,1660,960,302,46.3,2603,10322,4780,5542,86.3,7337,5500,17,10286,4766,5520
1025,Clarke County,AL,24128,11403,12725,89.6,1377,1320,1573,1584,1504,2611,2849,3220,1826,1585,2583,1524,572,42.5,5287,18841,8757,10084,86.8,12781,11044,104,18827,8757,10070
1027,Clay County,AL,13337,6438,6899,93.3,680,677,970,856,695,1503,1544,1746,1115,853,1539,873,286,43.3,2778,10559,5018,5541,90.6,11092,2075,21,10378,4961,5417
1029,Cleburne County,AL,14916,7309,7607,96.1,849,1116,834,876,760,1757,1729,2132,991,973,1696,752,451,43.1,3383,11533,5598,5935,94.3,14000,410,3,11396,5512,5884
1031,Coffee County,AL,51662,25479,26183,97.3,3207,3306,3634,3226,2996,6609,6679,6900,3613,2942,4976,2683,891,39.3,12259,39403,19168,20235,94.7,39118,8733,745,38416,18680,19736
1033,Colbert County,AL,54771,26284,28487,92.3,3139,3294,3085,3108,3186,6588,6602,7339,3782,4004,6055,3389,1200,42.4,11553,43218,20353,22865,89.0,43289,8872,259,42618,20052,22566
1035,Conecuh County,AL,12394,6078,6316,96.2,700,796,648,865,552,1340,1316,1537,799,1095,1708,724,314,44.8,2604,9790,4644,5146,90.2,6287,5919,56,9767,4633,5134
1037,Coosa County,AL,10757,5462,5295,103.2,364,440,665,573,456,1089,1289,1550,1145,756,1373,814,243,48.4,1801,8956,4478,4478,100.0,7078,3615,0,8907,4471,4436
1039,Covington County,AL,37200,17986,19214,93.6,2165,2426,2141,2143,2001,4363,4053,4754,2618,2810,4269,2628,829,43.3,8163,29037,13774,15263,90.2,31460,5018,184,28893,13731,15162
1041,Crenshaw County,AL,13844,6748,7096,95.1,788,852,915,831,768,1670,1577,1798,994,1042,1591,749,269,41.7,3106,10738,5126,5612,91.3,9879,3228,175,10614,5040,5574
1043,Cullman County,AL,82853,40759,42094,96.8,5115,4657,5673,4985,4697,10328,10141,10960,5673,5508,8961,4949,1206,40.8,18705,64148,31365,32783,95.7,78804,1073,314,62992,30686,32306
1045,Dale County,AL,49277,24301,24976,97.3,3231,3313,2944,2985,3295,7146,5832,6003,3581,2866,4708,2578,795,37.3,11385,37892,18467,19425,95.1,35655,10000,699,37106,18194,18912
1047,Dallas County,AL,39149,18039,21110,85.5,2393,2898,2422,2850,2386,4571,4383,4712,3006,2719,4078,2113,618,39.6,9429,29720,13290,16430,80.9,10906,27693,222,29382,13075,16307
1049,DeKalb County,AL,71310,35318,35992,98.1,4260,4732,5334,4851,4143,8484,8916,9361,4909,4437,7171,3703,1009,39.5,17510,53800,26270,27530,95.4,60924,1039,86,49663,23939,25724
1051,Elmore County,AL,81144,39226,41918,93.6,4737,4929,5284,5169,4932,11465,10874,11133,5621,4947,7426,3529,1098,38.7,18229,62915,29995,32920,91.1,61104,17449,439,62008,29562,32446
1053,Escambia County,AL,37057,18856,18201,103.6,2103,2183,2577,2191,2144,5005,4696,4661,2437,2494,3765,2116,685,40.0,8288,28769,14702,14067,104.5,23053,11878,102,28700,14641,14059
1055,Etowah County,AL,102748,49564,53184,93.2,5916,6103,6125,6302,6270,12248,12669,13832,7156,6870,11391,5922,1944,41.4,22169,80579,38257,42322,90.4,82027,16330,764,78975,37397,41578
1057,Fayette County,AL,16494,8138,8356,97.4,876,902,1087,996,927,1921,1881,2076,1190,1200,2002,1058,378,43.7,3480,13014,6225,6789,91.7,14068,1948,78,12985,6216,6769
1059,Franklin County,AL,31466,15676,15790,99.3,2219,1921,2387,1948,2205,4071,3653,3980,1715,2063,3044,1646,614,38.6,7884,23582,11661,11921,97.8,26118,1385,117,21848,10754,11094
1061,Geneva County,AL,26417,12835,13582,94.5,1440,1716,1621,1644,1336,2927,3021,3683,1987,1767,2960,1733,582,43.2,5818,20599,9882,10717,92.2,22870,2538,115,20428,9787,10641
1063,Greene County,AL,8324,3846,4478,85.9,578,557,419,377,600,1002,803,910,652,653,988,623,162,40.9,1884,6440,2961,3479,85.1,1439,6618,0,6433,2961,3472
1065,Hale County,AL,14809,7035,7774,90.5,984,899,962,1139,904,1630,1573,1801,971,1169,1609,856,312,40.5,3454,11355,5224,6131,85.2,5854,8796,33,11345,5224,6121
1067,Henry County,AL,17133,8319,8814,94.4,889,887,1166,1073,950,1636,2128,2204,1216,1199,2292,1066,427,44.4,3596,13537,6421,7116,90.2,12118,4565,68,13482,6371,7111
1069,Houston County,AL,104702,50190,54512,92.1,6401,6450,7157,6534,5961,13645,12950,13610,7597,6345,10556,5569,1927,40.1,24353,80349,37608,42741,88.0,72344,28157,930,79144,36881,42263
1071,Jackson County,AL,51852,25381,26471,95.9,2756,3153,3046,3062,2836,5924,6262,7059,3975,3666,6019,3165,929,43.1,10982,40870,19658,21212,92.7,47456,1809,232,40547,19492,21055
1073,Jefferson County,AL,659680,312033,347647,89.8,42520,41971,41809,41217,42420,95535,83537,81766,43734,43386,59561,29471,12753,37.7,151177,508503,235204,273299,86.1,341768,283311,10433,492660,226686,265974
1075,Lamar County,AL,13885,6783,7102,95.5,722,801,983,865,677,1456,1499,1879,992,1028,1618,971,394,44.8,3050,10835,5189,5646,91.9,12154,1479,17,10767,5144,5623
1077,Lauderdale County,AL,92556,44568,47988,92.9,4785,5013,5209,6120,7823,11095,10157,11608,6191,6327,10458,5591,2179,41.0,18309,74247,35058,39189,89.5,80436,9596,593,73191,34609,38582
1079,Lawrence County,AL,33058,15955,17103,93.3,1779,1933,2273,1954,1805,3974,3796,4827,2389,2330,3665,1791,542,42.4,7183,25875,12415,13460,92.2,25799,3502,65,25654,12359,13295
1081,Lee County,AL,161152,79453,81699,97.3,9527,9449,9746,13365,22010,23055,19465,18832,9168,7839,11670,5222,1804,31.9,34388,126764,61733,65031,94.9,113359,36920,6899,121502,58860,62642
1083,Limestone County,AL,94727,47291,47436,99.7,5217,5670,6577,6203,5118,12568,12861,13931,6620,5634,8743,4100,1485,39.7,21583,73144,36487,36657,99.5,76003,13028,1309,71281,35480,35801
1085,Lowndes County,AL,10079,4821,5258,91.7,613,587,653,559,605,1314,1055,1346,752,739,1057,604,195,42.0,2271,7808,3623,4185,86.6,2497,7522,0,7742,3589,4153
1087,Macon County,AL,18708,8593,10115,85.0,834,981,843,1791,2226,2049,1663,2133,1290,1284,2184,1024,406,38.6,3248,15460,6916,8544,80.9,3000,15560,32,15411,6872,8539
1089,Madison County,AL,362276,176935,185341,95.5,21250,21809,22564,24186,24707,50436,43930,50569,27733,21941,30731,16588,5832,38.5,79687,282589,136375,146214,93.3,246132,88011,9555,273524,131440,142084
1091,Marengo County,AL,19321,9299,10022,92.8,969,1431,1222,1401,1206,2034,2163,2473,1235,1458,2079,1219,431,42.2,4403,14918,6905,8013,86.2,8840,10348,0,14857,6868,7989
1093,Marion County,AL,29866,14781,15085,98.0,1552,1623,1918,1869,1632,3278,3360,4217,2242,1887,3480,2140,668,44.3,6274,23592,11467,12125,94.6,27739,1070,54,23435,11419,12016
1095,Marshall County,AL,95643,47230,48413,97.6,6615,6208,7042,6242,5581,11702,11511,12393,6176,6080,9426,5123,1544,38.8,23887,71756,34910,36846,94.7,88969,2549,573,66607,32035,34572
1097,Mobile County,AL,414114,197367,216747,91.1,27202,26110,27758,26772,27434,57737,49349,51615,27363,27435,39312,19160,6867,37.9,97811,316303,147900,168403,87.8,242715,148050,7928,311260,145146,166114
1099,Monroe County,AL,21270,10160,11110,91.4,1135,1364,1342,1530,1181,2277,2399,2813,1739,1390,2325,1171,604,43.3,4748,16522,7602,8920,85.2,11587,9026,58,16482,7588,8894
1101,Montgomery County,AL,226941,107049,119892,89.3,15346,15031,14320,15072,16602,32909,28318,27766,14751,13719,19379,10170,3558,36.4,53440,173501,80051,93450,85.7,81265,131408,6383,167710,77274,90436
1103,Morgan County,AL,119213,58712,60501,97.0,7181,8148,7108,7472,6826,14607,14798,16533,8269,7859,11879,6318,2215,40.6,27367,91846,44648,47198,94.6,95265,15230,760,88116,42493,45623
1105,Perry County,AL,9293,4263,5030,84.8,484,181,947,1170,628,804,1406,690,611,600,1171,479,122,36.9,2007,7286,3319,3967,83.7,2737,6491,8,7243,3276,3967
1107,Pickens County,AL,20243,9637,10606,90.9,1057,1051,1171,1171,1298,2516,2560,2837,1463,1380,2125,1088,526,42.2,4031,16212,7513,8699,86.4,11477,8134,12,15592,7487,8105
1109,Pike County,AL,33333,15980,17353,92.1,1826,1986,1637,2902,5684,3933,3266,3466,1887,1800,2846,1601,499,31.2,6470,26863,12628,14235,88.7,19301,12277,734,25834,12131,13703
1111,Randolph County,AL,22647,11057,11590,95.4,1317,1374,1332,1496,1352,2382,2464,3010,1234,2064,2717,1544,361,43.4,4896,17751,8466,9285,91.2,17452,4622,47,17634,8434,9200
1113,Russell County,AL,57952,27861,30091,92.6,4158,4361,3457,3329,3727,8645,7418,7487,3759,3582,4852,2455,722,36.3,14169,43783,20737,23046,90.0,28519,25300,553,42715,20272,22443
1115,St. Clair County,AL,87989,44013,43976,100.1,5171,5536,5911,5137,4810,11390,11465,12383,6637,5232,8751,4400,1166,40.3,20041,67948,33518,34430,97.4,76774,8447,745,67241,33097,34144
1117,Shelby County,AL,213432,103346,110086,93.9,12441,13887,15006,14478,12193,26300,29716,30210,14003,13482,19696,9279,2741,39.3,50625,162807,77712,85095,91.3,170998,25878,4399,156321,74582,81739
1119,Sumter County,AL,12797,5927,6870,86.3,715,752,567,1264,1411,1536,1128,1388,980,822,1226,764,244,35.6,2470,10327,4606,5721,80.5,3229,9204,274,10137,4520,5617
1121,Talladega County,AL,80387,38826,41561,93.4,4266,4943,4829,5119,5237,9864,9868,10873,5481,5855,8466,4285,1301,41.3,17257,63130,30137,32993,91.3,51398,26215,494,62381,29638,32743
1123,Tallapoosa County,AL,40541,19573,20968,93.3,2257,2698,2034,2327,2558,4314,4207,5363,3019,3259,5111,2624,770,44.7,8469,32072,15294,16778,91.2,28360,11123,145,31734,15082,16652
1125,Tuscaloosa County,AL,207305,100006,107299,93.2,12402,12294,11677,19657,22219,30577,24606,23335,11656,12209,16210,7724,2739,33.0,43618,163687,77752,85935,90.5,133130,66307,3341,158847,75129,83718
1127,Walker County,AL,64110,31453,32657,96.3,3923,3969,3835,3945,3656,7572,7437,8525,4661,4396,7200,3588,1403,42.1,14256,49854,24010,25844,92.9,58077,3961,331,49360,23708,25652
1129,Washington County,AL,16541,8159,8382,97.3,801,845,1157,1413,979,1670,1681,2528,1035,1385,1881,1002,164,43.7,3788,12753,6281,6472,97.0,10972,3894,42,12721,6270,6451
1131,Wilcox County,AL,10681,5014,5667,88.5,671,479,921,858,638,1134,1289,1198,655,812,1192,607,227,40.5,2577,8104,3781,4323,87.5,2915,7410,3,8071,3748,4323
1133,Winston County,AL,23784,11781,12003,98.2,1315,1098,1612,1372,1231,2576,2638,3286,1968,1613,2984,1615,476,45.2,4926,18858,9258,9600,96.4,22845,174,37,18572,9090,9482
2013,Aleutians East Borough,AK,3385,2033,1352,150.4,109,124,159,141,236,507,518,784,306,183,208,75,35,42.5,484,2901,1766,1135,155.6,510,142,666,2242,1334,908
2016,Aleutians West Census Area,AK,5698,3380,2318,145.8,189,378,299,269,436,1004,867,1082,475,352,257,78,12,38.6,982,4716,2887,1829,157.8,1660,191,2295,3381,2209,1172
2020,Anchorage Municipality,AK,293531,149670,143861,104.0,21197,20780,18457,18093,23134,51245,38010,36150,19254,16338,20568,7627,2678,33.6,71876,221655,112720,108935,103.5,183741,16341,28276,211008,108374,102634
2050,Bethel Census Area,AK,18134,9477,8657,109.5,1835,1764,1792,1585,1357,2852,1971,1866,863,948,884,313,104,27.3,6394,11740,6170,5570,110.8,2022,135,195,11533,6071,5462
2060,Bristol Bay Borough,AK,875,524,351,149.3,48,46,45,57,44,91,125,146,107,79,53,25,9,42.9,180,695,435,260,167.3,461,5,2,682,425,257
2068,Denali Borough,AK,2246,1201,1045,114.9,64,41,100,121,293,287,312,342,177,300,145,64,0,42.1,261,1985,1050,935,112.3,1892,26,58,1865,985,880
2070,Dillingham Census Area,AK,4961,2542,2419,105.1,469,412,425,382,378,733,583,504,290,286,333,127,39,30.2,1544,3417,1798,1619,111.1,866,79,67,3394,1792,1602
2090,Fairbanks North Star Borough,AK,99072,53417,45655,117.0,7808,6888,5954,5990,10586,18396,12183,10640,5485,5443,6811,2337,551,31.3,23943,75129,41201,33928,121.4,74722,4412,3207,73177,40459,32718
2100,Haines Borough,AK,2518,1297,1221,106.2,185,197,199,70,17,260,343,289,197,128,530,88,15,44.7,642,1876,1014,862,117.6,2055,0,33,1838,988,850
2105,Hoonah-Angoon Census Area,AK,2139,1142,997,114.5,90,107,91,63,77,241,230,340,231,230,323,100,16,49.6,322,1817,1011,806,125.4,986,68,34,1733,972,761
2110,Juneau City and Borough,AK,32227,16504,15723,105.0,1875,2018,1842,1964,1967,4917,4375,4438,2635,2157,2846,774,419,38.1,6944,25283,12889,12394,104.0,21917,320,2231,24233,12236,11997
2122,Kenai Peninsula Borough,AK,58464,30480,27984,108.9,3592,3579,3806,3675,3161,7305,7006,7329,4774,4606,6600,2163,868,40.8,13247,45217,23687,21530,110.0,48218,365,924,44496,23453,21043
2130,Ketchikan Gateway Borough,AK,13800,7083,6717,105.4,797,863,831,821,846,1874,1735,1826,1058,1099,1363,498,189,39.7,3033,10767,5542,5225,106.1,9178,104,1134,10331,5344,4987
2150,Kodiak Island Borough,AK,13451,7221,6230,115.9,991,1174,758,924,670,2469,1851,1525,806,964,948,310,61,33.9,3461,9990,5345,4645,115.1,7359,46,3055,8661,4655,4006
2158,Kusilvak Census Area,AK,8250,4463,3787,117.9,1076,868,922,738,636,1285,748,799,434,290,312,124,18,24.1,3330,4920,2710,2210,122.6,297,40,11,4880,2675,2205
2164,Lake and Peninsula Borough,AK,1393,749,644,116.3,87,88,91,78,131,225,203,183,96,102,62,38,9,34.8,323,1070,606,464,130.6,293,16,23,1047,596,451
2170,Matanuska-Susitna Borough,AK,105369,54838,50531,108.5,7517,7884,8269,7199,6314,15094,13969,13308,7480,6396,8213,2796,930,35.2,28396,76973,40160,36813,109.1,87323,1299,1453,75646,39590,36056
2180,Nome Census Area,AK,9988,5262,4726,111.3,987,997,957,777,750,1526,1140,1037,669,446,493,183,26,28.3,3434,6554,3477,3077,113.0,1555,95,166,6390,3396,2994
2185,North Slope Borough,AK,9792,5985,3807,157.2,793,743,636,572,543,1584,1309,1476,938,527,491,136,44,35.2,2563,7229,4629,2600,178.0,3077,151,534,6964,4553,2411
2188,Northwest Arctic Borough,AK,7715,4189,3526,118.8,818,791,743,588,566,1235,787,887,395,330,360,177,38,27.8,2720,4995,2769,2226,124.4,870,94,77,4945,2732,2213
2195,Petersburg Borough,AK,3257,1723,1534,112.3,209,179,154,166,354,331,300,373,269,205,466,204,47,42.8,649,2608,1382,1226,112.7,2480,33,153,2490,1344,1146
2198,Prince of Wales-Hyder Census Area,AK,6407,3478,2929,118.7,380,426,458,372,314,776,694,900,572,488,734,249,44,41.3,1501,4906,2690,2216,121.4,3056,29,91,4819,2655,2164
2220,Sitka City and Borough,AK,8640,4444,4196,105.9,383,581,589,484,457,1232,1252,1099,685,568,781,380,149,39.5,1877,6763,3397,3366,100.9,5554,80,579,6458,3299,3159
2230,Skagway Municipality,AK,1107,606,501,121.0,61,40,27,63,49,214,179,149,105,90,90,35,5,40.4,159,948,541,407,132.9,940,44,9,913,523,390
2240,Southeast Fairbanks Census Area,AK,6878,3770,3108,121.3,517,535,534,495,279,960,791,885,501,443,644,267,27,36.8,1864,5014,2841,2173,130.7,5257,45,183,4777,2662,2115
2261,Valdez-Cordova Census Area,AK,9243,4845,4398,110.2,584,683,580,459,457,1548,1018,1268,568,944,892,199,43,38.1,2156,7087,3743,3344,111.9,6633,35,376,6783,3654,3129
2275,Wrangell City and Borough,AK,2502,1357,1145,118.5,120,89,152,165,51,301,223,382,268,182,291,235,43,49.4,468,2034,1088,946,115.0,1577,1,18,1978,1042,936
2282,Yakutat City and Borough,AK,649,356,293,121.5,56,39,41,26,45,100,77,93,32,46,56,33,5,36.9,150,499,292,207,141.1,293,5,32,481,280,201
2290,Yukon-Koyukuk Census Area,AK,5377,2879,2498,115.3,400,496,358,367,314,732,585,597,415,343,533,174,63,35.2,1491,3886,2116,1770,119.5,1223,4,38,3851,2100,1751
4001,Apache County,AZ,71511,35155,36356,96.7,4813,5369,5865,5826,4689,9222,7717,8331,4511,4474,6477,3258,959,35.0,19551,51960,25562,26398,96.8,16328,373,246,51465,25246,26219
4003,Cochise County,AZ,125867,63967,61900,103.3,7414,8225,7179,7848,7562,15749,13938,13829,7162,9683,15678,8862,2738,41.1,27386,98481,50076,48405,103.5,107581,5132,2445,92840,47566,45274
4005,Coconino County,AZ,141274,69789,71485,97.6,7762,7469,9004,16574,17385,19468,15346,14689,8862,7732,10888,4628,1467,30.7,29304,111970,54561,57409,95.0,90333,1742,2766,108585,52603,55982
4007,Gila County,AZ,53546,26507,27039,98.0,2935,3061,2957,2486,2777,5255,4554,5800,3827,4695,8907,4730,1562,50.2,10732,42814,21037,21777,96.6,41171,375,439,41946,20665,21281
4009,Graham County,AZ,37996,20325,17671,115.0,2765,2612,3138,2967,2808,5684,4843,4097,1770,2110,2983,1577,642,33.6,10283,27713,15103,12610,119.8,30366,744,240,27018,14522,12496
4011,Greenlee County,AZ,9522,4984,4538,109.8,749,675,793,810,641,1236,1331,1049,583,477,615,483,80,34.5,2628,6894,3537,3357,105.4,8715,209,52,6763,3487,3276
4012,La Paz County,AZ,20793,10708,10085,106.2,962,1001,888,933,956,1732,1715,1919,1141,1521,3864,3581,580,56.5,3395,17398,8838,8560,103.2,16035,200,151,16049,8194,7855
4013,Maricopa County,AZ,4328810,2140563,2188247,97.8,278509,286828,302452,292371,289835,630096,565006,547001,258246,236652,373691,194336,73787,36.4,1046061,3282749,1606749,1676000,95.9,3360305,243640,181352,2933505,1431162,1502343
4015,Mohave County,AZ,207695,104944,102751,102.1,9109,9668,11144,10086,9297,21182,18844,23423,15718,17841,35172,20493,5718,51.6,36366,171329,86357,84972,101.6,187413,2217,2314,165724,83519,82205
4017,Navajo County,AZ,109270,54721,54549,100.3,7730,8112,8632,7817,6454,13192,11788,12195,7305,6983,11591,5622,1849,37.3,29450,79820,39708,40112,99.0,51496,1005,652,78206,38865,39341
4019,Pima County,AZ,1027207,505666,521541,97.0,58325,60145,61258,68885,90790,130050,116999,114824,63250,65320,112285,62024,23052,38.5,217133,810074,394956,415118,95.1,781004,36581,30011,746539,364482,382057
4021,Pinal County,AZ,432793,225618,207175,108.9,24924,28503,29411,26530,24072,57251,56742,48274,25039,26073,52433,27043,6498,39.3,99388,333405,174998,158407,110.5,345754,18915,7139,312528,163140,149388
4023,Santa Cruz County,AZ,46480,22271,24209,92.0,3311,3664,3445,3749,3009,4994,5174,5409,2698,2990,4672,2458,907,36.7,12710,33770,15998,17772,90.0,39840,301,424,27524,13340,14184
4025,Yavapai County,AZ,228067,111450,116617,95.6,9589,10545,10807,11643,10268,20738,20133,24907,17524,22055,41825,20837,7196,53.4,37729,190338,92111,98227,93.8,208248,1495,2205,184328,89186,95142
4027,Yuma County,AZ,209468,107841,101627,106.1,15071,14693,14759,14827,17602,29098,22658,21615,9872,10573,19439,15350,3911,34.6,53228,156240,80737,75503,106.9,159864,4533,2777,127429,66792,60637
5001,Arkansas County,AR,17914,8565,9349,91.6,1142,1192,1129,1068,960,2070,2062,2253,1198,1435,1968,1024,413,40.7,4103,13811,6555,7256,90.3,12921,4636,8,13746,6520,7226
5003,Ashley County,AR,20270,9825,10445,94.1,1234,1828,924,1275,1207,1935,2381,2660,1413,1377,2389,1130,517,41.7,4656,15614,7429,8185,90.8,14682,5150,39,15214,7161,8053
5005,Baxter County,AR,41427,20099,21328,94.2,1736,1822,2320,2127,1647,3919,3897,4733,3027,3420,6798,4592,1389,52.2,7267,34160,16315,17845,91.4,40058,67,180,34029,16259,17770
5007,Benton County,AR,265759,131999,133760,98.7,18710,19552,20583,17901,15106,39328,37825,33248,15236,12999,20608,10661,4002,35.4,70478,195281,95935,99346,96.6,232718,4541,10253,175894,85205,90689
5009,Boone County,AR,37331,18440,18891,97.6,2335,2459,2386,2110,2058,4470,4260,4736,2636,2290,4295,2246,1050,42.3,8607,28724,13994,14730,95.0,35900,125,139,28654,13941,14713
5011,Bradley County,AR,10874,5157,5717,90.2,663,845,676,712,458,1254,1410,1478,570,814,1057,713,224,40.6,2596,8278,3890,4388,88.7,7164,3135,7,7821,3663,4158
5013,Calhoun County,AR,5192,2609,2583,101.0,257,246,271,407,294,629,512,685,316,473,584,419,99,44.5,968,4224,2153,2071,104.0,3957,1125,0,4204,2141,2063
5015,Carroll County,AR,27965,13908,14057,98.9,1581,1638,1794,1693,1407,3000,2868,3425,1982,2270,3930,1785,592,45.0,6085,21880,10800,11080,97.5,25765,289,387,20393,9899,10494
5017,Chicot County,AR,10615,5239,5376,97.5,606,721,654,735,458,1263,1095,1318,913,732,1106,731,283,43.3,2364,8251,4082,4169,97.9,4614,5724,62,8098,3988,4110
5019,Clark County,AR,22386,10506,11880,88.4,1201,1094,1236,2474,3210,2202,2260,2492,1403,1180,1976,1118,540,33.7,4255,18131,8455,9676,87.4,15720,5434,156,17726,8250,9476
5021,Clay County,AR,14889,7329,7560,96.9,821,748,1087,892,816,1635,1764,1937,1068,980,1722,1080,339,42.8,3234,11655,5701,5954,95.8,14275,100,4,11609,5677,5932
5023,Cleburne County,AR,25100,12434,12666,98.2,1179,1408,1358,1310,1152,2453,2654,3048,1874,1945,3602,2331,786,49.4,4801,20299,9961,10338,96.4,24327,98,167,20088,9872,10216
5025,Cleveland County,AR,8128,4007,4121,97.2,422,504,581,553,369,860,956,1065,588,566,980,506,178,42.9,1808,6320,3090,3230,95.7,6970,1040,0,6261,3078,3183
5027,Columbia County,AR,23776,11407,12369,92.2,1445,1409,1291,2168,2802,2519,2611,2586,1339,1541,2186,1260,619,35.7,5011,18765,8782,9983,88.0,14396,8592,254,18518,8649,9869
5029,Conway County,AR,20858,10154,10704,94.9,1254,1339,1369,1328,1082,2419,2338,2814,1435,1541,2223,1114,602,42.5,4820,16038,7754,8284,93.6,17760,2167,69,15745,7585,8160
5031,Craighead County,AR,107345,52386,54959,95.3,7466,7848,7106,7892,8069,16399,13981,12299,6252,5523,8305,4699,1506,34.2,26756,80589,38381,42208,90.9,84590,15614,1510,77741,36845,40896
5033,Crawford County,AR,62739,30903,31836,97.1,3948,3755,4995,4247,3538,7897,7621,8198,4551,3713,6005,3233,1038,38.6,15472,47267,23053,24214,95.2,55246,993,1177,45894,22453,23441
5035,Crittenden County,AR,48672,23159,25513,90.8,3766,3772,3466,3466,3235,6411,5792,6118,2868,3159,3923,2065,631,35.2,13309,35363,16363,19000,86.1,21168,23352,337,34775,16031,18744
5037,Cross County,AR,16824,8094,8730,92.7,1066,1035,1197,1105,908,1955,2055,2157,1232,1030,1888,991,205,40.9,3979,12845,6103,6742,90.5,12380,3141,5,12809,6067,6742
5039,Dallas County,AR,7279,3589,3690,97.3,378,284,459,724,289,823,720,849,568,568,937,503,177,43.9,1564,5715,2754,2961,93.0,3888,3148,4,5702,2742,2960
5041,Desha County,AR,11709,5562,6147,90.5,748,748,981,772,634,1388,1219,1335,837,860,1261,646,280,40.1,3000,8709,4011,4698,85.4,5710,5456,51,8428,3905,4523
5043,Drew County,AR,18417,9023,9394,96.1,1123,874,1340,1733,1686,2146,2030,2052,1008,1298,1717,1079,331,37.4,4066,14351,6829,7522,90.8,12611,5289,60,14196,6725,7471
5045,Faulkner County,AR,123624,60393,63231,95.5,7640,8384,7800,10041,13890,17547,15486,14529,7099,6150,9168,4272,1618,32.8,28737,94887,45597,49290,92.5,101450,14094,1641,92473,44315,48158
5047,Franklin County,AR,17738,8735,9003,97.0,1124,1212,1114,1178,1093,1908,2034,2239,1069,1370,1896,1081,420,41.2,4224,13514,6624,6890,96.1,16682,174,146,13471,6601,6870
5049,Fulton County,AR,12231,6106,6125,99.7,603,743,702,707,625,1100,1193,1528,696,1212,1748,971,403,48.4,2526,9705,4791,4914,97.5,11736,58,8,9588,4706,4882
5051,Garland County,AR,98555,47295,51260,92.3,5260,6191,4931,5718,4988,11271,10946,11924,7168,7158,12944,7212,2844,45.0,19969,78586,37228,41358,90.0,84807,8092,588,76565,36279,40286
5053,Grant County,AR,18126,8893,9233,96.3,960,1331,1048,1062,1005,2201,2231,2550,1352,1158,1916,1111,201,41.0,4071,14055,6873,7182,95.7,17180,482,7,13881,6782,7099
5055,Greene County,AR,44937,22083,22854,96.6,2914,3237,2965,2890,2857,5873,5709,5967,3087,2362,4095,2285,696,38.0,11021,33916,16537,17379,95.2,42557,864,164,33669,16417,17252
5057,Hempstead County,AR,21842,10323,11519,89.6,1558,1443,1727,1367,1418,2151,2586,2782,1414,1491,2168,1215,522,40.4,5612,16230,7558,8672,87.2,12523,6582,26,15427,7224,8203
5059,Hot Spring County,AR,33597,17484,16113,108.5,1631,2048,2007,1853,1765,4711,4133,4466,2183,2512,3865,1871,552,41.3,6894,26703,13736,12967,105.9,28434,3834,133,26441,13557,12884
5061,Howard County,AR,13311,6388,6923,92.3,932,781,1065,1014,738,1518,1582,1654,781,900,1322,737,287,39.2,3457,9854,4630,5224,88.6,8967,2779,36,9277,4389,4888
5063,Independence County,AR,37427,18350,19077,96.2,2500,2473,2498,2459,2375,4387,4475,4779,2537,2491,3661,1942,850,39.3,8993,28434,13789,14645,94.2,34101,720,264,27770,13575,14195
5065,Izard County,AR,13570,7067,6503,108.7,641,500,876,696,662,1412,1393,1883,1125,992,1839,1202,349,47.9,2418,11152,5896,5256,112.2,12751,248,0,11069,5850,5219
5067,Jackson County,AR,17027,8427,8600,98.0,902,958,1004,940,1016,2571,2166,2196,1274,1014,1730,853,403,39.7,3440,13587,6682,6905,96.8,13230,2091,8,13587,6682,6905
5069,Jefferson County,AR,69282,34282,35000,97.9,4171,4233,4190,4812,4972,9111,8081,8558,4922,4607,6973,3079,1573,38.7,15292,53990,26395,27595,95.7,27475,39165,660,53273,26010,27263
5071,Johnson County,AR,26372,12966,13406,96.7,1645,1794,1846,1912,1754,3083,3242,3374,1806,1631,2554,1285,446,38.4,6376,19996,9773,10223,95.6,24056,421,543,18417,9060,9357
5073,Lafayette County,AR,6800,3440,3360,102.4,375,443,263,361,455,658,676,872,602,513,865,578,139,47.0,1323,5477,2615,2862,91.4,4077,2448,27,5407,2582,2825
5075,Lawrence County,AR,16549,8211,8338,98.5,939,969,1145,1160,1107,1888,1853,2078,975,1236,1769,980,450,40.8,3729,12820,6220,6600,94.2,15992,186,25,12749,6181,6568
5077,Lee County,AR,9194,5220,3974,131.4,469,427,473,490,581,1309,1280,1199,685,552,980,477,272,42.5,1675,7519,4358,3161,137.9,3949,5108,15,7424,4263,3161
5079,Lincoln County,AR,13455,8612,4843,177.8,552,489,661,483,956,2387,2218,2096,755,828,1231,567,232,39.0,2032,11423,7474,3949,189.3,8872,4106,0,11228,7306,3922
5081,Little River County,AR,12347,5966,6381,93.5,719,680,862,608,784,1324,1551,1578,833,861,1492,896,159,42.9,2738,9609,4539,5070,89.5,9124,2710,42,9593,4523,5070
5083,Logan County,AR,21668,10677,10991,97.1,1267,1282,1289,1335,1186,2487,2488,2985,1607,1458,2461,1405,418,42.0,4742,16926,8288,8638,95.9,19887,298,474,16791,8194,8597
5085,Lonoke County,AR,72528,35687,36841,96.9,4940,4506,5993,4920,3915,10727,9936,9419,4519,4104,5770,2937,842,36.2,18771,53757,26058,27699,94.1,64339,4110,653,53028,25704,27324
5087,Madison County,AR,16211,8034,8177,98.3,1112,959,1016,1143,802,1771,1788,2246,1319,994,1855,928,278,42.7,3816,12395,6179,6216,99.4,15176,49,203,12173,6068,6105
5089,Marion County,AR,16476,7959,8517,93.4,719,921,830,738,668,1446,1505,2000,1479,1539,2799,1490,342,52.2,2964,13512,6503,7009,92.8,15820,80,147,13380,6488,6892
5091,Miller County,AR,43572,21369,22203,96.2,2744,3036,2740,2823,2568,5825,5345,5704,2999,2652,4226,2223,687,39.5,10368,33204,15966,17238,92.6,30408,10789,173,32714,15792,16922
5093,Mississippi County,AR,42126,20436,21690,94.2,3037,2888,3215,3034,2701,5541,5058,5115,2992,2457,3593,1852,643,36.6,11094,31032,14829,16203,91.5,25411,14212,238,30596,14619,15977
5095,Monroe County,AR,7050,3308,3742,88.4,436,441,363,408,370,652,725,924,483,639,892,524,193,47.3,1477,5573,2583,2990,86.4,3847,3030,30,5571,2581,2990
5097,Montgomery County,AR,8950,4478,4472,100.1,413,482,429,490,449,788,891,1156,675,774,1354,810,239,50.4,1646,7304,3628,3676,98.7,8247,30,36,7114,3530,3584
5099,Nevada County,AR,8351,4237,4114,103.0,503,516,556,499,432,851,897,1179,621,604,1078,492,123,44.3,1900,6451,3127,3324,94.1,5247,2884,3,6450,3126,3324
5101,Newton County,AR,7812,3868,3944,98.1,351,459,430,432,414,712,806,913,490,814,1214,607,170,49.0,1545,6267,3065,3202,95.7,7356,2,51,6210,3059,3151
5103,Ouachita County,AR,23830,11371,12459,91.3,1448,1301,1805,1388,1508,2504,2489,3031,1773,1908,2662,1420,593,43.0,5431,18399,8457,9942,85.1,13582,9923,18,18295,8418,9877
5105,Perry County,AR,10355,5172,5183,99.8,580,752,557,609,605,1097,1157,1427,798,711,1217,636,209,43.7,2325,8030,3967,4063,97.6,9963,69,0,7995,3966,4029
5107,Phillips County,AR,18606,8738,9868,88.5,1389,1075,1535,1153,1455,1865,2015,2126,1324,1294,1978,937,460,38.9,4799,13807,6249,7558,82.7,6719,11750,0,13807,6249,7558
5109,Pike County,AR,10756,5312,5444,97.6,574,685,669,707,596,1167,1265,1410,593,921,1228,758,183,43.1,2339,8417,4190,4227,99.1,9774,439,61,8171,4068,4103
5111,Poinsett County,AR,23896,11644,12252,95.0,1531,1517,1659,1507,1390,2931,2791,3200,1676,1438,2546,1270,440,40.1,5693,18203,8701,9502,91.6,21113,1093,12,18039,8650,9389
5113,Polk County,AR,20094,9720,10374,93.7,1179,1177,1407,1343,935,2182,2151,2402,1333,1476,2605,1487,417,43.9,4672,15422,7452,7970,93.5,18409,95,57,14827,7104,7723
5115,Pope County,AR,63761,31330,32431,96.6,3984,4263,4049,5149,5815,8472,6780,7749,3863,3905,5598,2898,1236,35.3,14600,49161,24057,25104,95.8,58162,1909,658,46936,22979,23957
5117,Prairie County,AR,8189,4095,4094,100.0,442,418,501,462,388,864,856,1108,634,601,1007,678,230,47.2,1644,6545,3179,3366,94.4,7020,1017,17,6534,3168,3366
5119,Pulaski County,AR,392967,187895,205072,91.6,26292,27548,23138,23234,25990,58359,50228,48258,26650,24311,35448,15427,8084,37.2,91662,301305,141173,160132,88.2,219763,144802,8801,289210,134664,154546
5121,Randolph County,AR,17695,8839,8856,99.8,1067,956,1337,1158,945,2170,2024,2194,1038,1281,1912,1204,409,41.1,4147,13548,6650,6898,96.4,16842,192,21,13420,6562,6858
5123,St. Francis County,AR,25900,14094,11806,119.4,1666,1469,1754,1662,1435,3559,3696,3181,1749,1556,2493,1354,326,38.8,5964,19936,11021,8915,123.6,10630,13845,160,19613,10766,8847
5125,Saline County,AR,119415,58571,60844,96.3,6982,8062,7991,7640,6040,15259,16405,15293,7399,7431,12381,6577,1955,39.6,28006,91409,44241,47168,93.8,105610,8518,1528,89596,43306,46290
5127,Scott County,AR,10376,5313,5063,104.9,741,670,756,674,536,1139,1081,1281,702,646,1279,714,157,40.7,2641,7735,3825,3910,97.8,9239,25,75,7721,3815,3906
5129,Searcy County,AR,7908,3998,3910,102.3,383,393,514,417,408,795,774,1003,582,638,1126,665,210,47.9,1592,6316,3173,3143,101.0,7374,48,55,6266,3145,3121
5131,Sebastian County,AR,127591,62343,65248,95.5,8411,8547,8592,8456,8579,16835,15649,16404,8250,7974,11740,5990,2164,37.6,30810,96781,46761,50020,93.5,93752,8642,5737,90778,43422,47356
5133,Sevier County,AR,17081,8584,8497,101.0,1363,1226,1499,1237,1070,2068,2161,2089,1043,953,1423,693,256,35.3,4891,12190,6095,6095,100.0,10744,827,76,10054,4941,5113
5135,Sharp County,AR,17139,8397,8742,96.1,844,933,1151,1071,734,1572,1728,2163,1222,1286,2535,1404,496,47.6,3621,13518,6559,6959,94.3,16284,143,14,13462,6534,6928
5137,Stone County,AR,12475,6190,6285,98.5,570,573,786,691,637,1107,1243,1427,1317,789,1836,1214,285,50.1,2435,10040,4932,5108,96.6,12044,11,63,10023,4926,5097
5139,Union County,AR,39449,19101,20348,93.9,2631,2683,2661,2455,2256,4688,4617,4987,2632,3035,3911,2196,697,40.3,9527,29922,14301,15621,91.5,25201,12887,258,29440,13987,15453
5141,Van Buren County,AR,16642,8214,8428,97.5,780,920,969,994,744,1538,1671,2130,1224,1404,2305,1344,619,48.0,3300,13342,6516,6826,95.5,15816,101,37,13177,6430,6747
5143,Washington County,AR,232289,115916,116373,99.6,16009,16366,15510,19068,24336,34977,30625,25700,12209,11028,15851,7615,2995,32.0,57026,175263,86799,88464,98.1,179292,8545,5767,158473,77852,80621
5145,White County,AR,78762,38474,40288,95.5,4882,4716,5659,6008,6389,9527,9083,10243,5197,4367,7385,3851,1455,36.9,18452,60310,28996,31314,92.6,71754,3434,583,58791,28103,30688
5147,Woodruff County,AR,6533,3006,3527,85.2,379,483,343,300,366,628,714,872,551,416,861,466,154,45.5,1405,5128,2418,2710,89.2,4563,1839,59,5101,2418,2683
5149,Yell County,AR,21464,10755,10709,100.4,1371,1194,1721,1457,1224,2329,2669,2754,1600,1400,2128,1176,441,40.3,5237,16227,7998,8229,97.2,16873,526,237,14723,7221,7502
6001,Alameda County,CA,1656754,814515,842239,96.7,96849,95280,96770,94065,101128,276019,248230,223026,106831,94530,131979,63249,28798,37.6,344027,1312727,638603,674124,94.7,670364,175751,499382,1083648,523694,559954
6003,Alpine County,CA,1039,554,485,114.2,44,50,73,59,43,66,148,56,73,116,230,58,23,52.2,201,838,449,389,115.4,599,9,10,815,428,387
6005,Amador County,CA,38429,20640,17789,116.0,1527,1413,1843,1876,1475,4117,4294,5202,3094,3342,6318,2649,1279,50.5,5847,32582,17695,14887,118.9,33327,904,508,31698,17138,14560
6007,Butte County,CA,225817,111735,114082,97.9,12384,13721,11647,15658,24898,28999,24403,24385,14465,14572,23712,11837,5136,37.1,45439,180378,88334,92044,96.0,184180,3461,10432,173139,84724,88415
6009,Calaveras County,CA,45514,22663,22851,99.2,1902,2368,2041,2302,2053,4104,4336,5573,4148,4168,7547,3594,1378,52.0,7811,37703,18688,19015,98.3,41173,315,684,36843,18284,18559
6011,Colusa County,CA,21454,10994,10460,105.1,1576,1645,1643,1578,1335,2888,2559,2529,1466,1153,1870,881,331,35.3,5842,15612,7995,7617,105.0,18949,327,309,12366,6181,6185
6013,Contra Costa County,CA,1142251,558502,583749,95.7,65449,72450,76514,73311,67349,145275,153127,162899,80233,69762,103232,50361,22289,39.7,261203,881048,425105,455943,93.2,637904,99642,190983,761019,365900,395119
6015,Del Norte County,CA,27495,14745,12750,115.6,1532,1489,1960,1583,1287,3985,3718,3250,2187,1777,2870,1248,609,39.5,5920,21575,11687,9888,118.2,20581,940,888,20579,11098,9481
6017,El Dorado County,CA,188563,93922,94641,99.2,8670,10193,11783,11272,9617,19070,21100,26182,16494,15612,23843,10712,4015,45.9,37922,150641,74466,76175,97.8,165234,1516,8540,143861,71623,72238
6019,Fresno County,CA,984521,491146,493375,99.5,77711,77832,80556,72062,72223,150576,122667,110839,54311,47967,68692,32889,16196,32.2,280844,703677,347843,355834,97.8,639985,46782,101857,588878,286304,302574
6021,Glenn County,CA,27976,14218,13758,103.3,2049,1776,2364,2034,1802,3424,3370,3255,1560,1882,2507,1407,546,36.4,7485,20491,10250,10241,100.1,22685,230,825,17298,8627,8671
6023,Humboldt County,CA,135940,67576,68364,98.8,7235,7427,7212,8935,12668,18413,17177,14868,8981,9506,14795,5860,2863,38.4,26137,109803,54377,55426,98.1,108557,1506,4196,106325,52526,53799
6025,Imperial County,CA,180701,92752,87949,105.5,15080,13357,15038,13648,13453,26562,22086,20156,9531,8949,12818,7022,3001,32.4,51853,128848,66256,62592,105.9,117658,4489,2680,103885,54468,49417
6027,Inyo County,CA,17977,9062,8915,101.6,998,1110,928,978,759,1930,2097,2137,1379,1564,2305,1268,524,45.8,3609,14368,7177,7191,99.8,14170,153,350,13605,6805,6800
6029,Kern County,CA,887641,454843,432798,105.1,70269,71414,74919,66060,67180,137412,112260,100951,49090,43374,57162,26953,10597,31.6,258089,629552,323692,305860,105.8,660147,48550,42100,521859,267630,254229
6031,Kings County,CA,150691,82995,67696,122.6,11642,11400,11679,10359,12695,25371,20661,17679,7733,6409,8748,4745,1570,31.8,41039,109652,62125,47527,130.7,102062,9642,5817,93191,52673,40518
6033,Lake County,CA,64195,31865,32330,98.6,3731,3722,3624,3695,2997,6967,6880,7822,4891,5533,8902,4148,1283,45.6,13400,50795,25155,25640,98.1,49389,1447,723,47962,23372,24590
6035,Lassen County,CA,30818,20332,10486,193.9,1428,1132,1267,1405,2971,6307,4452,3696,1895,1886,2662,1254,463,36.6,4602,26216,17852,8364,213.4,25324,2686,428,25071,16881,8190
6037,Los Angeles County,CA,10081570,4969382,5112188,97.2,611485,596485,627199,641814,717692,1623246,1379814,1355625,629508,562724,758833,393364,183781,36.5,2214760,7866810,3836220,4030590,95.2,5168443,820478,1473221,6319285,3061635,3257650
6039,Madera County,CA,155433,74972,80461,93.2,11611,12306,12062,11051,10876,21551,19330,17846,8987,8382,12996,6174,2261,34.1,42853,112580,53245,59335,89.7,108100,4949,3229,91909,42563,49346
6041,Marin County,CA,259943,126956,132987,95.5,12164,14276,16528,14871,11701,22640,30897,41007,20033,19656,32829,16735,6606,46.8,52633,207310,100296,107014,93.7,202313,5767,15367,185230,88889,96341
6043,Mariposa County,CA,17420,8872,8548,103.8,736,816,827,642,767,1895,1656,2140,1613,1538,2793,1589,408,51.7,2840,14580,7426,7154,103.8,15402,253,210,14101,7138,6963
6045,Mendocino County,CA,87224,43242,43982,98.3,5076,5532,4992,4988,4631,9843,10211,10378,6229,6812,11991,4692,1849,43.1,18702,68522,33734,34788,97.0,72935,628,1805,62192,30368,31824
6047,Merced County,CA,271382,136987,134395,101.9,21311,22464,23198,23544,20477,39448,33276,30660,13820,13228,17412,9211,3333,31.1,80459,190923,95759,95164,100.6,149434,8645,20349,150155,74119,76036
6049,Modoc County,CA,8907,4626,4281,108.1,444,530,467,453,273,1033,931,910,611,854,1378,821,202,47.8,1752,7155,3686,3469,106.3,7976,136,99,6765,3440,3325
6051,Mono County,CA,14310,7634,6676,114.3,500,776,777,960,1370,2115,1763,1651,1404,945,1370,622,57,37.7,2671,11639,6093,5546,109.9,11921,111,367,9866,5369,4497
6053,Monterey County,CA,433410,221001,212409,104.0,31503,31683,32720,30792,31044,62605,56417,51264,25407,22735,33366,15625,8249,34.4,113869,319541,162827,156714,103.9,230992,11367,24326,231872,117221,114651
6055,Napa County,CA,139623,69603,70020,99.4,7053,7511,9189,8940,8707,17190,17582,18579,9946,8958,14738,7829,3401,41.3,29201,110422,54501,55921,97.5,102467,2883,11352,95556,46570,48986
6057,Nevada County,CA,99244,48947,50297,97.3,4177,4904,4872,5074,4217,9607,10911,11758,8248,9222,16234,6787,3233,50.5,17099,82145,40131,42014,95.5,91726,570,1073,80115,39250,40865
6059,Orange County,CA,3168044,1563832,1604212,97.5,187823,186384,205390,206633,213390,456061,412451,449051,212979,182777,257618,135942,61545,38.1,704508,2463536,1203639,1259897,95.5,1931263,55591,649042,2060449,1002065,1058384
6061,Placer County,CA,385512,188162,197350,95.3,20520,24692,25244,24550,20109,42273,49723,52733,26125,25771,42097,22688,8987,42.0,86331,299181,144131,155050,93.0,316716,6626,28909,285075,137331,147744
6063,Plumas County,CA,18660,9282,9378,99.0,808,896,885,955,637,1774,1838,2183,1495,2139,3221,1432,397,52.3,3117,15543,7760,7783,99.7,16855,166,222,15228,7608,7620
6065,Riverside County,CA,2411439,1200960,1210479,99.2,157599,168073,180144,177328,168426,334925,308273,303594,145907,126595,193685,106789,40101,35.6,614149,1797290,887656,909634,97.6,1444654,156836,157261,1555774,770140,785634
6067,Sacramento County,CA,1524553,744997,779556,95.6,99076,102000,101952,94860,98085,238929,201047,193563,96266,89179,123276,58987,27333,36.2,363176,1161377,559844,601533,93.1,873905,149891,239447,1041824,500615,541209
6069,San Benito County,CA,60376,30151,30225,99.8,3883,4066,4864,4493,4112,8137,7871,8046,3968,3407,4527,2109,893,35.7,15678,44698,22310,22388,99.7,49245,491,1804,38329,19166,19163
6071,San Bernardino County,CA,2149031,1069766,1079265,99.1,153784,158284,161928,158167,166248,325532,276105,266119,128390,112513,147810,68535,25616,33.3,571568,1577463,777523,799940,97.2,1315238,179292,154332,1364253,671305,692948
6073,San Diego County,CA,3316073,1669515,1646558,101.4,209680,195758,199915,207980,256169,545838,441301,415472,202994,186877,261738,131454,60897,35.8,722738,2593335,1299849,1293486,100.5,2345667,166750,394742,2265800,1143944,1121856
6075,San Francisco County,CA,874961,446286,428675,104.1,39536,31339,29842,30469,48445,205361,138126,115305,50782,50775,73974,39276,21731,38.2,117546,757415,386289,371126,104.1,406056,45556,301018,652449,330713,321736
6077,San Joaquin County,CA,742603,370152,372451,99.4,52388,57536,58195,55603,51426,103464,96140,91997,42578,40195,54930,26721,11430,34.3,202701,539902,266145,273757,97.2,419288,51931,115531,458995,224995,234000
6079,San Luis Obispo County,CA,282165,143006,139159,102.8,13154,13781,14666,22164,29543,32839,30535,31534,18966,20136,32463,15667,6717,39.2,50176,231989,117405,114584,102.5,241123,5319,10296,218760,110322,108438
6081,San Mateo County,CA,767423,379328,388095,97.7,43940,44952,44303,40810,42128,113405,110150,107467,52083,47308,67858,35173,17846,39.7,159504,607919,297536,310383,95.9,388318,17784,220151,501484,243220,258264
6083,Santa Barbara County,CA,444829,222659,222170,100.2,28159,27437,27608,37510,49023,59202,50350,48793,26085,24099,36297,20104,10162,33.8,99184,345645,172223,173422,99.3,344778,8984,24849,281934,139281,142653
6085,Santa Clara County,CA,1927470,974422,953048,102.2,116508,117494,124086,114241,120183,309599,279571,266848,120804,103962,141994,77225,34955,37.1,428382,1499088,754874,744214,101.4,857092,47992,702881,1175132,584883,590249
6087,Santa Cruz County,CA,273962,135634,138328,98.1,14192,14368,15368,22832,27202,33633,31911,34098,18811,18392,27359,11335,4461,37.8,53121,220841,108534,112307,96.6,204866,2904,13134,192861,94014,98847
6089,Shasta County,CA,179212,88047,91165,96.6,10544,10917,10530,10425,10272,22866,19564,21521,13107,13194,21397,10786,4089,41.5,38679,140533,68229,72304,94.4,155124,2088,5798,136211,66129,70082
6091,Sierra County,CA,3040,1625,1415,114.8,123,151,154,101,91,271,342,295,448,172,541,309,42,54.8,482,2558,1361,1197,113.7,2963,2,0,2506,1309,1197
6093,Siskiyou County,CA,43468,21708,21760,99.8,2327,2894,2129,2399,2037,4437,4339,4866,3632,3676,6725,3023,984,47.8,8826,34642,17127,17515,97.8,36847,695,708,33760,16612,17148
6095,Solano County,CA,441829,219818,222011,99.0,26798,27194,28182,26611,29345,64538,55270,57064,29849,29669,41051,18135,8123,38.1,98839,342990,169207,173783,97.4,232437,61526,68200,309099,152750,156349
6097,Sonoma County,CA,499772,244045,255727,95.4,25137,27730,28727,29843,29021,64563,62062,65057,35516,37203,58048,25649,11216,42.1,99190,400582,193460,207122,93.4,373667,8269,20443,357328,171232,186096
6099,Stanislaus County,CA,543194,268871,274323,98.0,39376,40607,42909,39333,37343,78604,68638,65683,33647,27375,40856,20596,8227,34.1,147623,395571,193636,201935,95.9,415911,16547,30007,339433,164515,174918
6101,Sutter County,CA,96109,47866,48243,99.2,6557,7138,7167,6533,6088,13439,11760,11437,5555,6017,7966,4515,1937,35.7,25059,71050,34916,36134,96.6,66293,1827,15048,61221,30038,31183
6103,Tehama County,CA,63912,31773,32139,98.9,3839,3989,4828,3803,3603,7723,7135,7689,4477,4519,7053,3749,1505,41.0,15258,48654,24034,24620,97.6,54795,530,967,45884,22626,23258
6105,Trinity County,CA,12700,6535,6165,106.0,586,653,515,685,414,1024,1410,1596,1049,1358,2067,1068,275,52.5,2166,10534,5379,5155,104.3,10924,127,226,10227,5237,4990
6107,Tulare County,CA,461898,230966,230932,100.0,37791,41276,40603,37303,33574,65493,57735,51153,23701,21738,30356,14773,6402,31.0,143158,318740,157754,160986,98.0,340462,7201,16690,256924,124472,132452
6109,Tuolumne County,CA,54045,28112,25933,108.4,2434,2625,2398,2552,2732,6554,5821,6130,4112,4860,8164,4033,1630,48.4,8987,45058,23547,21511,109.5,47447,984,754,44215,23070,21145
6111,Ventura County,CA,847263,419111,428152,97.9,50525,52120,59301,57026,58145,112915,105041,114038,59468,51056,73778,36653,17197,38.1,196787,650476,319333,331143,96.4,678658,15594,62190,563242,273775,289467
6113,Yolo County,CA,217352,105438,111914,94.2,12312,12498,13326,21009,30621,29614,25603,23459,11935,10579,15404,7382,3610,31.0,46026,171326,82135,89191,92.1,150617,5847,30462,145880,69472,76408
6115,Yuba County,CA,76360,38950,37410,104.1,5993,6312,5612,4943,5467,12193,9422,8308,4331,4404,5886,2549,940,32.8,21078,55282,27899,27383,101.9,58016,2621,5201,51018,25688,25330
8001,Adams County,CO,504108,254500,249608,102.0,36419,38494,38836,33856,32248,82216,74004,62859,30408,23663,31870,13964,5271,33.8,135860,368248,185051,183197,101.0,411153,17014,19930,323019,160772,162247
8003,Alamosa County,CO,16107,8059,8048,100.1,1116,1013,1226,1484,1649,2290,1789,1574,987,849,1300,644,186,31.8,3933,12174,6042,6132,98.5,13918,144,213,11372,5567,5805
8005,Arapahoe County,CO,644560,318960,325600,98.0,40412,42702,44405,39746,39408,100383,91892,84608,40947,37946,51014,21631,9466,36.6,153589,490971,240401,250570,95.9,461113,69853,38957,442776,215851,226925
8007,Archuleta County,CO,13253,6657,6596,100.9,602,682,708,558,566,1275,1369,1543,1080,1486,2431,819,134,50.9,2302,10951,5438,5513,98.6,11136,230,126,10707,5353,5354
8009,Baca County,CO,3561,1744,1817,96.0,180,234,215,175,149,388,402,355,256,281,458,326,142,46.0,748,2813,1362,1451,93.9,3357,34,0,2736,1315,1421
8011,Bent County,CO,5787,3735,2052,182.0,197,247,279,217,313,1120,1034,620,396,331,618,262,153,40.2,878,4909,3352,1557,215.3,5287,238,12,4709,3195,1514
8013,Boulder County,CO,322510,162211,160299,101.2,14795,17454,18722,25307,33477,44811,40645,42180,20694,20331,27241,11814,5039,36.6,62446,260064,130316,129748,100.4,286950,2944,15281,241903,120815,121088
8014,Broomfield County,CO,67886,33817,34069,99.3,3698,4510,4659,4267,3760,10295,10032,9620,4587,3432,5580,2540,906,37.8,15741,52145,25811,26334,98.0,58579,875,4420,49892,24687,25205
8015,Chaffee County,CO,19557,10488,9069,115.6,741,747,982,871,693,2454,2243,2635,1454,1838,2988,1388,523,49.2,2944,16613,8898,7715,115.3,18324,330,290,16328,8712,7616
8017,Cheyenne County,CO,2026,1012,1014,99.8,217,156,138,133,44,200,242,251,180,130,157,120,58,39.4,608,1418,708,710,99.7,1894,2,44,1341,667,674
8019,Clear Creek County,CO,9495,4778,4717,101.3,375,285,484,702,273,990,1136,1555,887,962,1338,424,84,48.1,1505,7990,4104,3886,105.6,8947,114,91,7860,3985,3875
8021,Conejos County,CO,8128,4088,4040,101.2,540,546,663,595,498,803,893,932,506,639,879,531,103,38.8,2164,5964,3026,2938,103.0,7216,40,15,5900,2993,2907
8023,Costilla County,CO,3745,1985,1760,112.8,156,146,218,237,195,292,377,447,294,360,629,334,60,51.9,684,3061,1597,1464,109.1,3311,14,48,2861,1472,1389
8025,Crowley County,CO,5754,3654,2100,174.0,164,226,195,662,624,969,681,812,333,318,476,188,106,35.4,709,5045,3270,1775,184.2,5098,203,34,4870,3105,1765
8027,Custer County,CO,4776,2442,2334,104.6,49,182,309,263,161,271,275,410,489,650,1187,457,73,59.7,716,4060,2074,1986,104.4,4441,138,0,4038,2054,1984
8029,Delta County,CO,30565,15453,15112,102.3,1508,1642,1806,1983,1333,2836,3386,3275,2497,2572,4497,2369,861,47.3,6081,24484,12296,12188,100.9,28866,367,323,23826,11858,11968
8031,Denver County,CO,705576,353311,352265,100.3,42830,40467,36642,33940,42979,162830,111990,81668,36131,34611,49238,21663,10587,34.5,139687,565889,282436,283453,99.6,537029,65215,26156,505889,250904,254985
8033,Dolores County,CO,1857,1042,815,127.9,122,135,127,45,30,205,193,199,169,119,300,148,65,48.8,408,1449,749,700,107.0,1795,0,0,1435,741,694
8035,Douglas County,CO,336041,167729,168312,99.7,19880,23923,28459,25107,16833,36795,50603,54476,23482,18066,25258,9707,3452,38.7,89235,246806,121825,124981,97.5,298665,4874,16079,236633,116780,119853
8037,Eagle County,CO,54681,29060,25621,113.4,3087,3289,3578,3449,2773,8867,8459,8507,3736,3059,4230,1476,171,37.0,11993,42688,22823,19865,114.9,48591,642,357,36169,19408,16761
8039,Elbert County,CO,25717,13020,12697,102.5,1141,1510,1715,1786,1239,2250,2873,4405,2513,2301,2791,870,323,46.1,5572,20145,10140,10005,101.3,24062,110,259,19822,10018,9804
8041,El Paso County,CO,698974,352903,346071,102.0,47167,47238,47286,48022,57146,110682,88233,84198,43657,38234,53653,24326,9132,34.2,169876,529098,266217,262881,101.3,556174,44801,19567,508591,256706,251885
8043,Fremont County,CO,47321,27599,19722,139.9,1847,2181,2018,2091,2242,6953,6271,6597,3789,3322,5914,3107,989,45.1,7495,39826,23764,16062,148.0,42504,2177,320,39194,23195,15999
8045,Garfield County,CO,59055,30109,28946,104.0,3985,4932,3664,3781,3395,8110,8348,7591,4010,3762,4810,1836,831,36.5,14980,44075,22434,21641,103.7,50833,286,532,38114,19231,18883
8047,Gilpin County,CO,6018,3048,2970,102.6,144,273,256,245,177,486,963,1087,453,855,822,169,88,49.0,818,5200,2623,2577,101.8,5562,20,0,5050,2601,2449
8049,Grand County,CO,15303,8087,7216,112.1,575,649,905,846,747,2234,1952,2049,1260,1525,1845,451,265,42.9,2669,12634,6739,5895,114.3,14510,172,213,12167,6339,5828
8051,Gunnison County,CO,16802,9101,7701,118.2,739,781,842,1424,2415,2304,2080,1945,983,1103,1482,482,222,34.5,2908,13894,7563,6331,119.5,16083,95,57,13559,7335,6224
8053,Hinsdale County,CO,857,385,472,81.6,37,20,42,39,16,69,78,104,115,127,131,59,20,56.1,138,719,331,388,85.3,807,0,4,716,328,388
8055,Huerfano County,CO,6679,3288,3391,97.0,232,353,345,193,340,523,588,768,732,522,1224,614,245,55.0,1074,5605,2752,2853,96.5,6140,34,0,5514,2730,2784
8057,Jackson County,CO,1261,648,613,105.7,33,38,64,87,65,116,126,152,143,80,210,137,10,51.6,185,1076,559,517,108.1,1234,0,0,1049,545,504
8059,Jefferson County,CO,574798,286412,288386,99.3,29880,31749,32912,33005,32427,84122,77039,78027,43297,40371,56133,25169,10667,40.3,115079,459719,227425,232294,97.9,520619,6839,16256,444106,219516,224590
8061,Kiowa County,CO,1489,722,767,94.1,177,60,119,45,92,154,122,153,124,75,182,141,45,42.5,393,1096,488,608,80.3,1433,6,0,1092,484,608
8063,Kit Carson County,CO,7447,3994,3453,115.7,425,565,532,376,351,1056,903,843,494,537,726,423,216,38.3,1796,5651,3002,2649,113.3,6861,186,14,5224,2667,2557
8065,Lake County,CO,7751,4308,3443,125.1,199,497,385,482,625,1476,1151,1113,480,525,596,124,98,36.7,1400,6351,3495,2856,122.4,6614,9,65,5799,3137,2662
8067,La Plata County,CO,55617,27999,27618,101.4,2900,2942,3052,3575,3375,7624,7383,6982,4153,4481,6086,2196,868,40.4,10610,45007,22536,22471,100.3,48924,276,406,44416,22263,22153
8069,Larimer County,CO,344786,172000,172786,99.5,17731,18624,20301,24431,36912,50079,42361,38634,21883,21669,32279,14141,5741,36.0,68390,276396,137080,139316,98.4,314957,3387,7546,266621,131716,134905
8071,Las Animas County,CO,14266,7485,6781,110.4,620,768,685,816,850,1724,1531,1639,1164,1092,2030,1009,338,45.9,2532,11734,6187,5547,111.5,12111,125,137,11239,5864,5375
8073,Lincoln County,CO,5585,3561,2024,175.9,308,326,301,208,325,951,862,627,405,301,505,292,174,38.0,1123,4462,2973,1489,199.7,4971,459,23,4274,2856,1418
8075,Logan County,CO,22380,12086,10294,117.4,1650,955,1171,1925,1524,3072,2512,2899,1275,1559,2036,1112,690,38.2,4598,17782,9816,7966,123.2,20452,189,185,16988,9464,7524
8077,Mesa County,CO,151218,74601,76617,97.4,8602,9156,9754,10049,9483,20039,17885,17185,10429,10557,16305,7923,3851,39.7,33030,118188,57737,60451,95.5,142163,1020,1411,114981,56265,58716
8079,Mineral County,CO,824,422,402,105.0,15,42,26,16,28,78,84,116,84,114,136,65,20,56.1,96,728,371,357,103.9,720,9,4,728,371,357
8081,Moffat County,CO,13127,6797,6330,107.4,889,985,922,731,707,2005,1534,1582,877,1087,1129,572,107,36.6,3361,9766,4969,4797,103.6,12388,158,18,9272,4677,4595
8083,Montezuma County,CO,26031,12874,13157,97.8,1377,1658,1632,1416,1336,2744,2714,3327,1977,2245,3467,1452,686,45.2,5691,20340,9910,10430,95.0,21077,72,196,19952,9785,10167
8085,Montrose County,CO,41686,20526,21160,97.0,2335,2407,2739,2492,1989,4191,4613,4998,3159,3128,5526,3298,811,45.2,9079,32607,15893,16714,95.1,39254,163,386,31170,15216,15954
8087,Morgan County,CO,28517,14348,14169,101.3,2052,2212,1944,2095,1813,3752,3357,3379,1899,1630,2364,1581,439,36.2,7426,21091,10560,10531,100.3,25319,1038,152,18509,9096,9413
8089,Otero County,CO,18282,8904,9378,94.9,1077,1158,1388,1564,958,1907,2210,1913,1182,1254,2030,1224,417,39.9,4410,13872,6682,7190,92.9,16479,113,167,13304,6307,6997
8091,Ouray County,CO,4796,2437,2359,103.3,205,148,276,167,149,395,568,562,403,593,931,282,117,54.1,763,4033,2002,2031,98.6,4684,15,35,3991,1974,2017
8093,Park County,CO,17867,9515,8352,113.9,707,682,891,785,653,1796,2030,2775,2077,1905,2677,674,215,50.7,2782,15085,8062,7023,114.8,16856,56,123,14903,8001,6902
8095,Phillips County,CO,4290,2226,2064,107.8,359,298,331,262,240,566,498,416,284,295,363,283,95,37.1,1143,3147,1700,1447,117.5,4146,9,22,2738,1496,1242
8097,Pitkin County,CO,17926,9344,8582,108.9,818,852,707,928,941,2855,2173,2628,1191,1641,2170,803,219,41.8,2882,15044,7813,7231,108.0,16339,174,403,13754,7339,6415
8099,Prowers County,CO,12022,6132,5890,104.1,814,847,892,995,700,1347,1325,1346,867,797,1188,629,275,38.3,3071,8951,4455,4496,99.1,11351,95,70,8166,3990,4176
8101,Pueblo County,CO,165982,81738,84244,97.0,9604,10031,11311,11183,10388,21420,19673,19862,11033,11279,17395,9198,3605,39.3,37629,128353,62472,65881,94.8,133497,3494,1489,125801,60861,64940
8103,Rio Blanco County,CO,6384,3260,3124,104.4,401,621,321,388,440,828,706,725,507,474,540,303,130,36.9,1547,4837,2433,2404,101.2,5898,30,8,4729,2392,2337
8105,Rio Grande County,CO,11305,5632,5673,99.3,647,606,824,862,711,1067,1498,1248,746,900,1286,658,252,42.1,2611,8694,4261,4433,96.1,10346,106,8,8305,4046,4259
8107,Routt County,CO,25072,13044,12028,108.4,1100,1364,1165,1604,1299,3824,3578,3517,2192,1765,2563,802,299,40.2,4599,20473,10746,9727,110.5,24002,232,285,19887,10456,9431
8109,Saguache County,CO,6592,3283,3309,99.2,346,459,385,371,202,602,683,838,591,640,1050,337,88,49.0,1437,5155,2596,2559,101.4,5948,33,0,4779,2407,2372
8111,San Juan County,CO,589,292,297,98.3,25,7,35,9,28,72,55,91,39,82,100,34,12,51.2,76,513,265,248,106.9,573,0,0,513,265,248
8113,San Miguel County,CO,8049,4240,3809,111.3,302,397,536,317,448,1305,1214,1210,626,606,859,195,34,41.8,1445,6604,3473,3131,110.9,7619,1,149,6143,3240,2903
8115,Sedgwick County,CO,2322,1109,1213,91.4,240,129,125,154,60,227,233,269,185,163,253,168,116,44.1,584,1738,865,873,99.1,2175,19,22,1692,839,853
8117,Summit County,CO,30649,16696,13953,119.7,1309,1416,1431,1255,1879,5681,4950,4535,2195,2084,2911,928,75,39.1,4977,25672,14218,11454,124.1,27978,342,179,23552,12930,10622
8119,Teller County,CO,24524,12480,12044,103.6,898,1213,1386,1216,1080,2315,2534,3543,2463,2713,3790,1162,211,50.0,4323,20201,10297,9904,104.0,23221,208,193,19922,10197,9725
8121,Washington County,CO,4868,2550,2318,110.0,253,297,354,290,284,593,542,537,373,368,516,339,122,41.6,1111,3757,1935,1822,106.2,4641,63,29,3672,1898,1774
8123,Weld County,CO,305345,154294,151051,102.1,22053,24022,21493,21909,19328,46287,41478,37354,17776,17428,22677,9818,3722,34.4,80402,224943,113123,111820,101.2,275792,3643,4833,209084,104687,104397
8125,Yuma County,CO,10003,4977,5026,99.0,726,714,830,523,564,1329,1027,1225,564,676,975,535,315,37.8,2663,7340,3630,3710,97.8,9587,112,5,6531,3258,3273
9001,Fairfield County,CT,943926,459636,484290,94.9,52132,58195,63990,66533,59791,107749,117977,141011,69676,60251,80334,44062,22225,40.6,214502,729424,350233,379191,92.4,688856,109186,50339,631596,298087,333509
9003,Hartford County,CT,893561,433975,459586,94.4,47803,49892,56391,58438,57815,117499,109578,123282,63804,59170,82599,43894,23396,40.4,189177,704384,337660,366724,92.1,631471,123117,47734,650772,310174,340598
9005,Litchfield County,CT,182002,90109,91893,98.1,7453,9177,10016,10779,9958,18550,19184,28090,15753,15585,21823,10199,5435,47.3,33690,148312,72627,75685,96.0,168841,3165,3438,142679,69955,72724
9007,Middlesex County,CT,163053,79641,83412,95.5,6736,7533,8941,10282,10228,18165,18113,24637,14213,12133,18342,9071,4659,45.7,29313,133740,64493,69247,93.1,143486,9119,5017,128808,62229,66579
9009,New Haven County,CT,857513,413519,443994,93.1,44503,46525,51112,58615,59558,114190,100830,117789,61152,57498,81393,41739,22609,40.3,174834,682679,324010,358669,90.3,628640,115837,34656,635333,300112,335221
9011,New London County,CT,267390,134037,133353,100.5,13298,13273,16046,16667,20149,34676,29742,36753,20339,19026,27392,14017,6012,41.4,52401,214989,107150,107839,99.4,215896,15537,11091,205885,102858,103027
9013,Tolland County,CT,151063,75601,75462,100.2,6143,6905,8135,14723,19070,16299,15475,20273,10846,10054,13528,6788,2824,37.7,26575,124488,61981,62507,99.2,132820,4806,7371,119937,59678,60259
9015,Windham County,CT,116566,57727,58839,98.1,5740,6500,6694,8212,8028,14614,13840,16593,9021,8612,11011,5117,2584,41.2,23341,93225,45677,47548,96.1,104021,2649,1611,90399,44187,46212
10001,Kent County,DE,176699,85199,91500,93.1,11042,10931,11943,11962,12767,23877,20521,21974,12028,10237,17324,9193,2900,37.7,40761,135938,64513,71425,90.3,116954,45424,3552,131146,62373,68773
10003,New Castle County,DE,556165,269189,286976,93.8,32329,31716,35481,37324,35989,80574,68634,75636,38526,35688,49170,25029,10069,38.4,120649,435516,208092,227424,91.5,357185,139960,30704,405496,192560,212936
10005,Sussex County,DE,224384,108502,115882,93.6,11459,11127,12782,10608,10468,23167,21443,26644,17212,18985,37692,17339,5458,49.6,42274,182110,87209,94901,91.9,184098,26918,2753,173638,82630,91008
11001,District of Columbia,DC,692683,328644,364039,90.3,45040,34261,28945,37440,52881,161872,102301,76123,36739,33411,48154,24338,11178,34.0,123930,568753,266022,302731,87.9,285857,320811,27592,519267,241214,278053
12001,Alachua County,FL,265443,128220,137223,93.4,14098,13567,12586,22928,40440,41237,28747,26379,14721,14427,21838,9663,4812,31.6,47742,217701,103995,113706,91.5,182813,53278,16125,204426,96919,107507
12003,Baker County,FL,28211,14701,13510,108.8,1786,1793,1936,1768,1863,4089,3444,4036,1771,1852,2430,1042,401,37.7,6733,21478,11222,10256,109.4,23279,3824,173,21274,11072,10202
12005,Bay County,FL,182161,90531,91630,98.8,11172,10631,10882,9911,11127,25802,22080,24124,13829,11555,17988,9551,3509,39.8,38949,143212,70775,72437,97.7,147657,20057,4269,138605,68551,70054
12007,Bradford County,FL,27317,15021,12296,122.2,1307,1726,1580,1292,1533,4417,3494,3472,1685,1944,2708,1651,508,39.7,5418,21899,12163,9736,124.9,21101,5544,166,21599,11955,9644
12009,Brevard County,FL,585507,286412,299095,95.8,27316,27195,33455,31754,30962,65424,60485,77254,49343,45158,73904,45359,17898,47.3,107753,477754,231048,246706,93.7,482985,56493,13854,461178,223399,237779
12011,Broward County,FL,1926205,938043,988162,94.9,112234,109367,117687,112065,112656,260432,257142,275787,135083,119691,174920,93500,45641,40.4,410180,1516025,729856,786169,92.8,1170083,551097,68988,1277219,614657,662562
12013,Calhoun County,FL,14362,7917,6445,122.8,636,825,891,739,747,2129,1866,1951,1051,772,1598,743,414,41.6,2902,11460,6423,5037,127.5,11553,1904,16,11273,6272,5001
12015,Charlotte County,FL,181067,88465,92602,95.5,5413,6215,6235,7091,6679,13590,13528,19750,14849,15982,38379,23519,9837,59.1,22216,158851,76878,81973,93.8,162847,10113,2342,151392,73085,78307
12017,Citrus County,FL,145169,70474,74695,94.3,5280,5459,6870,6198,5834,11647,11527,16274,11435,11984,28642,17770,6249,56.5,21545,123624,59303,64321,92.2,134668,4288,2567,121031,58115,62916
12019,Clay County,FL,211405,104304,107101,97.4,11667,14006,14426,14737,12003,26416,27292,29746,15342,13227,20659,9293,2591,39.7,49705,161700,78740,82960,94.9,167504,23291,5896,157187,76879,80308
12021,Collier County,FL,371453,182946,188507,97.0,16683,17166,19253,18359,17872,35543,36164,43711,24064,25441,58669,42585,15943,50.8,64594,306859,149938,156921,95.5,329909,25404,4861,259884,124544,135340
12023,Columbia County,FL,69968,36232,33736,107.4,4214,4610,3818,4399,4472,8896,8144,8910,4846,4868,7478,3936,1377,40.4,15179,54789,28569,26220,109.0,53651,12653,744,53551,27892,25659
12027,DeSoto County,FL,36903,20836,16067,129.7,1861,2051,1970,2372,2215,5259,4467,4401,2012,2293,4423,2793,786,40.9,7209,29694,17165,12529,137.0,31079,4634,83,25902,14408,11494
12029,Dixie County,FL,16589,9289,7300,127.2,734,980,785,718,845,1908,1981,2213,1383,1269,2242,1188,343,46.5,3002,13587,7643,5944,128.6,14333,1474,38,13371,7527,5844
12031,Duval County,FL,936186,454084,482102,94.2,63375,58254,57710,54069,63144,154153,118636,119680,63486,55236,78404,35852,14187,36.2,212052,724134,346091,378043,91.5,559532,277195,43297,683940,325938,358002
12033,Escambia County,FL,313491,155157,158334,98.0,18927,17638,18590,21572,25714,45668,34248,37128,22070,20027,30458,15825,5626,37.2,65613,247878,121725,126153,96.5,213368,68733,9367,241336,118676,122660
12035,Flagler County,FL,109801,52399,57402,91.3,4255,5199,5770,6097,4628,9693,10783,13272,8010,9172,19175,10567,3180,51.3,18832,90969,43201,47768,90.4,90342,11010,2874,87530,41512,46018
12037,Franklin County,FL,11811,6734,5077,132.6,518,473,620,501,576,1689,1389,1590,858,916,1664,705,312,46.4,1898,9913,5721,4192,136.5,9555,1664,41,9734,5604,4130
12039,Gadsden County,FL,45945,21790,24155,90.2,2704,2730,2957,2627,2776,5545,6065,6007,2986,3591,4727,2395,835,40.8,10043,35902,16811,19091,88.1,18202,25786,81,34429,15862,18567
12041,Gilchrist County,FL,17953,9415,8538,110.3,888,764,1131,1675,1226,1850,1950,2263,1373,1196,2063,1065,509,42.1,3737,14216,7374,6842,107.8,16382,1052,40,13789,7150,6639
12043,Glades County,FL,13516,7509,6007,125.0,428,526,840,847,663,1541,1513,1789,938,793,1981,1294,363,47.9,2080,11436,6461,4975,129.9,10780,1819,108,10435,6035,4400
12045,Gulf County,FL,15576,9109,6467,140.9,722,781,610,694,815,2279,1900,2215,1219,1120,1950,974,297,44.9,2538,13038,7741,5297,146.1,12384,2673,85,12750,7496,5254
12047,Hamilton County,FL,14326,8403,5923,141.9,629,849,764,837,859,2258,1726,2002,1063,908,1539,682,210,40.9,2732,11594,6888,4706,146.4,8805,4949,43,11129,6642,4487
12049,Hardee County,FL,27131,14696,12435,118.2,1757,1993,2117,1948,1846,3674,3319,3243,1381,1568,2401,1389,495,35.4,7111,20020,10761,9259,116.2,21824,2051,234,18385,9821,8564
12051,Hendry County,FL,40732,21600,19132,112.9,3003,2707,3435,2884,3032,5511,5040,5278,2620,1877,2973,1738,634,34.0,10982,29750,15771,13979,112.8,32023,4688,355,22901,11483,11418
12053,Hernando County,FL,186313,89454,96859,92.4,8459,8923,10596,9989,8906,18903,18977,23292,13570,13493,27593,17317,6295,49.0,34415,151898,72127,79771,90.4,165227,9946,2283,148358,70415,77943
12055,Highlands County,FL,103437,50361,53076,94.9,4882,4585,5331,5008,4603,9821,8963,10191,6699,6945,17512,13911,4986,53.5,17772,85665,41329,44336,93.2,83541,9987,1467,79617,38086,41531
12057,Hillsborough County,FL,1422278,695072,727206,95.6,87972,88483,89403,89696,92911,217291,194383,192931,89263,81764,118339,56807,23035,37.2,319660,1102618,531166,571452,93.0,1002119,239119,57655,989694,471655,518039
12059,Holmes County,FL,19432,10546,8886,118.7,917,1050,1154,1078,1153,2548,2301,2690,1403,1288,2160,1336,354,42.7,3794,15638,8475,7163,118.3,17237,1356,131,15365,8249,7116
12061,Indian River County,FL,153989,73951,80038,92.4,6437,7263,6847,7723,7215,13356,14046,17726,10929,12762,25955,16300,7430,53.5,25295,128694,60887,67807,89.8,133103,13633,2037,121654,57237,64417
12063,Jackson County,FL,47945,26318,21627,121.7,2390,2303,2587,2714,2857,6495,6511,6395,3477,2982,5223,3018,993,41.7,8940,39005,21687,17318,125.2,33057,12859,156,38116,21068,17048
12065,Jefferson County,FL,14161,7432,6729,110.4,604,694,657,557,669,1632,1821,2012,1002,1264,1990,884,375,48.0,2307,11854,6320,5534,114.2,8894,4894,39,11483,6032,5451
12067,Lafayette County,FL,8637,5125,3512,145.9,461,691,318,610,619,1338,1219,1186,540,467,669,443,76,37.3,1899,6738,4177,2561,163.1,6931,1394,0,6395,4010,2385
12069,Lake County,FL,345867,167643,178224,94.1,17014,17420,20665,18383,16514,37265,37424,42628,22170,24569,49730,31906,10179,46.9,66910,278957,133234,145723,91.4,285337,37766,7000,266828,126745,140083
12071,Lee County,FL,737468,361232,376236,96.0,34344,35280,38931,37633,36434,80451,76241,87476,49808,53701,114068,68727,24374,48.5,131552,605916,293754,312162,94.1,622299,63282,11967,548242,263434,284808
12073,Leon County,FL,289770,137486,152284,90.3,15053,14773,15162,26016,46543,41897,31338,30079,16123,15406,23403,9947,4030,31.0,54215,235555,109822,125733,87.3,177974,89536,10183,226572,105147,121425
12075,Levy County,FL,40403,19718,20685,95.3,2027,2564,1995,2175,2027,4311,4092,5024,3122,3332,5811,2883,1040,46.9,7947,32456,15640,16816,93.0,35391,3541,349,31614,15217,16397
12077,Liberty County,FL,8345,4973,3372,147.5,313,396,372,582,720,1149,1128,1251,636,518,777,387,116,40.7,1376,6969,4250,2719,156.3,6682,1320,20,6790,4077,2713
12079,Madison County,FL,18460,9866,8594,114.8,901,960,1006,1150,848,2640,2188,2461,1410,1180,2246,1115,355,43.5,3462,14998,7985,7013,113.9,10713,7128,163,14604,7667,6937
12081,Manatee County,FL,384213,185822,198391,93.7,18377,19823,20476,19886,18608,40464,39446,47339,27799,28318,56412,34080,13185,48.3,71335,312878,149479,163399,91.5,328110,33462,7975,288547,137309,151238
12083,Marion County,FL,353526,169652,183874,92.3,17643,17346,19627,17806,17557,37966,34708,41076,25034,23525,55176,34603,11459,48.7,65983,287543,135947,151596,89.7,289561,45754,5088,278528,130803,147725
12085,Martin County,FL,159065,78707,80358,97.9,6453,6455,8419,8028,7080,14484,14563,20225,12018,12666,24092,16574,8008,52.2,26275,132790,65200,67590,96.5,140110,9006,2226,125680,61024,64656
12086,Miami-Dade County,FL,2699428,1311459,1387969,94.5,157980,146907,154732,156300,169415,385096,372333,396911,178291,150557,229753,139097,62056,39.9,553263,2146165,1029461,1116704,92.2,2028500,469202,43152,1592214,747226,844988
12087,Monroe County,FL,75798,39491,36307,108.8,3489,2792,3350,3135,3540,9409,9227,11382,6247,6438,10473,4785,1531,47.7,11455,64343,33644,30699,109.6,66728,5545,1058,57649,30382,27267
12089,Nassau County,FL,83098,41211,41887,98.4,4205,4427,4893,4617,3874,9372,9792,10992,6448,6594,11127,5365,1392,45.3,16559,66539,32457,34082,95.2,75070,5031,851,65264,31875,33389
12091,Okaloosa County,FL,203794,103422,100372,103.0,13463,12161,12680,11001,14411,32580,24426,24169,14416,12442,18693,9909,3443,36.9,45251,158543,80265,78278,102.5,159371,20032,6188,152888,77820,75068
12093,Okeechobee County,FL,41144,22205,18939,117.2,2472,2429,2391,2553,2347,5161,4947,5467,2711,2531,4299,2813,1023,41.1,8882,32262,17398,14864,117.0,35138,3414,395,29171,15593,13578
12095,Orange County,FL,1349746,662036,687710,96.3,82998,82480,85238,89431,105224,227169,191640,178464,81063,68887,94929,44083,18140,35.1,301720,1048026,508159,539867,94.1,857963,282677,69700,922714,448066,474648
12097,Osceola County,FL,351955,173562,178393,97.3,22355,23141,25562,24864,23877,50614,50971,46895,19548,18510,27654,13363,4601,35.9,86668,265287,129020,136267,94.7,256320,40336,9662,234010,113727,120283
12099,Palm Beach County,FL,1465027,710241,754786,94.1,75202,77203,79435,81596,79597,174466,168510,190924,98675,93375,168626,118401,59017,44.8,281775,1183252,566495,616757,91.9,1077422,273384,39423,1027169,485271,541898
12101,Pasco County,FL,524602,255248,269354,94.8,27274,29436,31077,29664,26422,58048,63666,70518,36381,33914,65185,39780,13237,44.5,106798,417804,200655,217149,92.4,456080,30221,13580,397915,191431,206484
12103,Pinellas County,FL,964666,463198,501468,92.4,42428,43569,44140,44880,48253,115655,105709,131866,77076,76275,125841,73294,35680,48.1,158263,806403,382437,423966,90.2,785739,98942,32679,762406,360797,401609
12105,Polk County,FL,686218,336279,349939,96.1,39987,41337,44935,43186,41517,88420,81054,83172,42748,41521,77946,45813,14582,40.2,152859,533359,257988,275371,93.7,528843,104676,12244,499745,240570,259175
12107,Putnam County,FL,73252,36255,36997,98.0,4180,4091,4775,4006,3923,8053,7553,8789,5909,5339,9729,5419,1486,45.1,15710,57542,28152,29390,95.8,58814,11922,456,55744,27133,28611
12109,St. Johns County,FL,244674,119055,125619,94.8,12316,14735,16415,15730,12075,23808,31431,34990,18609,16328,29521,13622,5094,43.7,53415,191259,91998,99261,92.7,216331,13224,6595,185976,89400,96576
12111,St. Lucie County,FL,312947,152727,160220,95.3,16265,16276,18983,17498,16654,35461,34798,39100,22969,20583,40545,24898,8917,45.1,62684,250263,120474,129789,92.8,228616,63087,6383,229673,110972,118701
12113,Santa Rosa County,FL,174755,89306,85449,104.5,9918,9945,11779,10818,10129,23436,22930,24604,12456,11131,16823,8403,2383,39.9,38600,136155,69457,66698,104.1,149250,10858,3423,133086,68180,64906
12115,Sarasota County,FL,419496,200053,219443,91.2,14937,16417,17656,18142,17314,35233,35624,48054,30049,34861,76768,51413,23028,56.1,60382,359114,169039,190075,88.9,381414,19002,7129,338728,159465,179263
12117,Seminole County,FL,461402,223000,238402,93.5,24450,27987,27164,28037,28813,66756,63217,64944,31501,28422,41349,19266,9496,39.2,97626,363776,173488,190288,91.2,349813,55186,20895,341484,162703,178781
12119,Sumter County,FL,125044,62567,62477,100.1,2280,2073,3098,2918,2464,6820,7990,8430,7222,10831,42220,23209,5489,67.4,9090,115954,57853,58101,99.6,111290,8818,1105,113536,56222,57314
12121,Suwannee County,FL,44046,22633,21413,105.7,2185,3024,2872,2305,2525,4714,5469,5810,3265,2841,5187,2941,908,43.3,9571,34475,17867,16608,107.6,36431,5683,55,33026,16978,16048
12123,Taylor County,FL,21870,12254,9616,127.4,1006,1227,1425,1169,943,3279,2831,2722,1304,1660,2578,1460,266,42.0,4321,17549,9970,7579,131.5,16678,4397,167,17223,9749,7474
12125,Union County,FL,15303,9979,5324,187.4,893,878,675,755,884,2458,2339,1991,1181,959,1540,569,181,39.3,2922,12381,8518,3863,220.5,11268,3359,93,12097,8288,3809
12127,Volusia County,FL,536487,261504,274983,95.1,25358,26575,26413,29440,31372,62125,56130,67786,40758,40967,72297,39845,17421,46.6,95179,441308,213099,228209,93.4,436700,58584,9618,427157,205916,221241
12129,Wakulla County,FL,32321,17541,14780,118.7,1510,1908,1991,2043,1526,4187,4890,4859,2409,2283,2982,1361,372,40.6,6862,25459,14048,11411,123.1,26579,4874,167,25063,13735,11328
12131,Walton County,FL,68262,34533,33729,102.4,4034,3367,4279,3454,3100,8326,8375,9266,5586,5165,8381,3696,1233,44.0,13933,54329,27439,26890,102.0,59228,3156,705,52632,26751,25881
12133,Washington County,FL,24764,13409,11355,118.1,1175,1364,1463,1388,1493,3546,3152,3472,1895,1548,2579,1253,436,41.5,4792,19972,11066,8906,124.3,19725,3764,167,19508,10846,8662
13001,Appling County,GA,18440,9318,9122,102.1,1236,1396,1122,1357,1041,2136,2109,2399,1362,1175,1879,940,288,40.3,4577,13863,6848,7015,97.6,13750,3561,74,13305,6579,6726
13003,Atkinson County,GA,8239,4179,4060,102.9,526,658,659,820,376,987,1132,975,598,391,718,328,71,36.4,2223,6016,3007,3009,99.9,6196,1444,0,5196,2550,2646
13005,Bacon County,GA,11201,5473,5728,95.5,795,849,751,704,748,1475,1492,1255,824,587,1038,567,116,36.7,2872,8329,4024,4305,93.5,8956,1701,19,8053,3888,4165
13007,Baker County,GA,3132,1530,1602,95.5,101,208,184,223,167,304,357,474,172,199,427,264,52,46.1,656,2476,1190,1286,92.5,1710,1244,96,2376,1162,1214
13009,Baldwin County,GA,45111,22815,22296,102.3,2216,2554,2292,4590,5289,5273,4722,5453,2838,2925,4239,2043,677,35.5,8505,36606,18512,18094,102.3,24245,19102,791,35902,18173,17729
13011,Banks County,GA,18708,9400,9308,101.0,1010,1115,1331,1276,1018,2195,2367,2744,1378,1195,1944,916,219,41.1,4347,14361,7084,7277,97.3,17392,486,210,13841,6827,7014
13013,Barrow County,GA,78991,38740,40251,96.2,5461,5960,5888,5173,4590,11625,11180,10535,4973,3861,6302,2650,793,35.7,20745,58246,28192,30054,93.8,62276,9340,2928,55478,26696,28782
13015,Bartow County,GA,104919,51825,53094,97.6,6860,6965,7289,6827,6733,13793,13577,15029,7909,5574,9061,4006,1296,38.1,25645,79274,38693,40581,95.3,87869,10931,933,75703,36814,38889
13017,Ben Hill County,GA,17033,8139,8894,91.5,1095,756,1664,1306,1051,1708,2016,2224,1224,1139,1711,829,310,39.9,4274,12759,5939,6820,87.1,10163,6236,117,12380,5672,6708
13019,Berrien County,GA,19152,9384,9768,96.1,1208,1468,1158,1191,934,2409,2434,2539,1315,1132,2076,925,363,39.6,4648,14504,7049,7455,94.6,15904,2247,212,14093,6799,7294
13021,Bibb County,GA,153200,71915,81285,88.5,10533,10468,10453,10683,11132,20801,17693,18617,9888,9696,13619,6493,3124,36.4,37614,115586,52757,62829,84.0,61569,83405,3113,113405,51683,61722
13023,Bleckley County,GA,12807,6054,6753,89.6,754,712,745,1566,1179,1317,1273,1498,729,773,1282,766,213,35.8,2726,10081,4693,5388,87.1,8955,3522,31,10016,4669,5347
13025,Brantley County,GA,18756,9198,9558,96.2,1120,1383,1141,1289,1055,2165,2244,2702,1411,1238,1897,904,207,41.1,4458,14298,6926,7372,94.0,17610,661,201,14118,6805,7313
13027,Brooks County,GA,15590,7612,7978,95.4,983,908,1018,1054,562,2013,1767,2062,905,1374,1731,1016,197,42.0,3455,12135,5787,6348,91.2,9298,5604,66,11867,5665,6202
13029,Bryan County,GA,37063,18476,18587,99.4,2706,3154,3148,2807,1891,4990,6092,4591,2150,1642,2430,1070,392,34.6,10872,26191,12758,13433,95.0,28542,5340,529,25515,12450,13065
13031,Bulloch County,GA,76120,37316,38804,96.2,4324,3835,4573,9157,11674,10573,8043,7885,3758,3819,5228,2464,787,28.8,15216,60904,29633,31271,94.8,49581,21245,990,59452,29023,30429
13033,Burke County,GA,22520,10715,11805,90.8,1646,1225,2019,1483,1419,2760,2571,2816,1554,1643,2125,926,333,37.4,5878,16642,7750,8892,87.2,10988,10824,75,16342,7547,8795
13035,Butts County,GA,24090,12846,11244,114.2,1331,1275,1519,1306,1676,3760,3067,3378,1730,1341,2326,1139,242,38.6,4937,19153,10376,8777,118.2,16393,6992,101,18746,10157,8589
13037,Calhoun County,GA,6365,3891,2474,157.3,201,243,453,370,388,1003,997,930,345,477,555,288,115,39.6,1123,5242,3273,1969,166.2,2163,3851,37,5045,3119,1926
13039,Camden County,GA,53231,27495,25736,106.8,3820,3630,3479,3618,5055,8498,5984,6076,3551,2758,4373,1998,391,32.8,12817,40414,20883,19531,106.9,38864,9997,1170,39278,20343,18935
13043,Candler County,GA,10812,5339,5473,97.6,569,915,859,691,581,1304,1237,1339,886,541,1175,514,201,38.7,2709,8103,3920,4183,93.7,7242,2743,185,7627,3630,3997
13045,Carroll County,GA,117183,57024,60159,94.8,7401,7207,8375,9598,10471,15782,14553,14779,7263,6104,9583,4737,1330,34.8,28012,89171,42676,46495,91.8,87519,22664,904,86060,40825,45235
13047,Catoosa County,GA,66700,32000,34700,92.2,3801,4172,4468,4371,3929,8073,8704,9180,4114,4403,6822,3782,881,40.4,15378,51322,24104,27218,88.6,61587,1497,878,50566,23621,26945
13049,Charlton County,GA,13040,7455,5585,133.5,718,529,921,994,733,1719,1683,2199,794,810,1096,670,174,41.2,2536,10504,6277,4227,148.5,8661,3419,96,9456,5286,4170
13051,Chatham County,GA,288496,138879,149617,92.8,18505,17343,16541,18755,23020,47707,35425,33541,18410,16199,25824,12416,4810,35.6,62086,226410,107318,119092,90.1,152025,115023,7428,216689,102220,114469
13053,Chattahoochee County,GA,10560,6875,3685,186.6,885,661,527,1243,2122,2526,1117,591,192,358,192,125,21,24.5,2245,8315,5757,2558,225.1,7136,2270,382,8179,5703,2476
13055,Chattooga County,GA,24812,12858,11954,107.6,1436,1625,1604,1471,1569,3080,3255,3227,1643,1607,2495,1363,437,39.4,5585,19227,10008,9219,108.6,21271,2593,42,18589,9658,8931
13057,Cherokee County,GA,247515,121808,125707,96.9,14898,16140,19323,16921,13953,29715,34711,37555,16422,14618,21850,9185,2224,38.7,61567,185948,90215,95733,94.2,213668,17274,4472,174532,83926,90606
13059,Clarke County,GA,126176,60045,66131,90.8,6706,5950,6186,14074,22346,20963,14172,11172,5777,5479,8050,4006,1295,28.0,21899,104277,48852,55425,88.1,79862,35215,4891,96264,44727,51537
13061,Clay County,GA,2951,1427,1524,93.6,111,152,188,186,117,311,315,284,263,262,407,268,87,49.8,564,2387,1180,1207,97.8,1056,1841,30,2369,1172,1197
13063,Clayton County,GA,283538,132756,150782,88.0,21627,21864,23138,20569,20526,44023,37792,37281,16614,14534,17455,6165,1950,32.5,79522,204016,92713,111303,83.3,46348,196495,14592,185108,82676,102432
13065,Clinch County,GA,6686,3380,3306,102.2,458,455,552,481,309,724,906,898,504,360,613,340,86,39.9,1724,4962,2369,2593,91.4,4383,1900,0,4821,2268,2553
13067,Cobb County,GA,751218,363539,387679,93.8,47301,50597,50468,50516,48547,109487,106854,107931,49638,40839,56878,23596,8566,36.7,179829,571389,272619,298770,91.2,440462,207059,40271,513130,242217,270913
13069,Coffee County,GA,43021,22155,20866,106.2,2937,3292,2518,2974,3083,5967,5661,5794,2597,2325,3719,1697,457,36.3,10559,32462,16698,15764,105.9,29175,12261,338,30859,15788,15071
13071,Colquitt County,GA,45486,22504,22982,97.9,3119,3323,3526,3039,2991,5758,5833,5727,2887,2346,4035,2304,598,36.8,11911,33575,16280,17295,94.1,29029,10622,380,30158,14324,15834
13073,Columbia County,GA,150705,73770,76935,95.9,9594,10985,11031,10134,8913,20869,21135,20015,9390,8755,12368,5757,1759,36.9,38417,112288,54263,58025,93.5,111355,25127,5846,107727,52042,55685
13075,Cook County,GA,17177,8224,8953,91.9,1125,1179,1313,1191,1067,2039,2162,2277,1038,1057,1598,890,241,37.3,4396,12781,6006,6775,88.6,11796,4631,124,12450,5840,6610
13077,Coweta County,GA,143260,69744,73516,94.9,8713,9697,10597,10090,8351,17483,19086,21748,9756,8392,12185,5571,1591,39.0,35540,107720,51812,55908,92.7,109508,25618,2980,103754,49668,54086
13079,Crawford County,GA,12325,6484,5841,111.0,661,668,794,902,594,1272,1479,1774,1110,852,1452,647,120,44.4,2626,9699,4930,4769,103.4,9236,2708,19,9671,4902,4769
13081,Crisp County,GA,22713,10958,11755,93.2,1445,1709,1361,1870,1187,2565,2632,2691,1602,1514,2403,1293,441,38.5,5516,17197,7970,9227,86.4,11973,10344,43,16906,7887,9019
13083,Dade County,GA,16197,7913,8284,95.5,776,742,1050,1532,986,1732,1961,2028,1252,1070,1874,833,361,42.6,3090,13107,6286,6821,92.2,15318,134,285,12951,6213,6738
13085,Dawson County,GA,24536,12224,12312,99.3,1315,1128,1586,1471,1511,2823,2838,3467,1506,1978,3234,1286,393,43.6,4982,19554,9637,9917,97.2,23628,258,144,19276,9539,9737
13087,Decatur County,GA,26682,12823,13859,92.5,1790,1673,1948,1831,1696,3395,3179,3455,1972,1476,2428,1478,361,37.8,6524,20158,9578,10580,90.5,14002,11225,66,19639,9368,10271
13089,DeKalb County,GA,749323,354278,395045,89.7,52967,48449,47018,43604,47594,125500,107499,99404,46307,41474,56142,23384,9981,35.8,174846,574477,265464,309013,85.9,257388,404889,45447,514556,234021,280535
13091,Dodge County,GA,20829,10958,9871,111.0,1065,1056,1292,1061,1483,2546,2831,2994,1561,1298,2315,1099,228,41.8,4106,16723,8749,7974,109.7,14001,5987,69,16495,8579,7916
13093,Dooly County,GA,13736,7433,6303,117.9,548,545,847,1020,857,1313,2168,1701,975,1120,1597,750,295,43.2,2433,11303,6243,5060,123.4,6194,6741,2,10932,5991,4941
13095,Dougherty County,GA,89703,41433,48270,85.8,5974,5634,6474,6837,7244,12098,10366,10235,5437,5686,8163,4098,1457,35.6,21642,68061,30402,37659,80.7,23655,62417,867,66919,29663,37256
13097,Douglas County,GA,143316,68291,75025,91.0,8996,9663,11809,10836,9412,18004,19864,21551,8872,7991,10516,4261,1541,36.5,37410,105906,49220,56686,86.8,66197,67249,2324,100187,46560,53627
13099,Early County,GA,10312,4793,5519,86.8,674,759,704,549,800,1068,1151,1301,631,718,1123,492,342,39.9,2597,7715,3502,4213,83.1,4670,5409,57,7674,3471,4203
13101,Echols County,GA,3981,1888,2093,90.2,175,315,187,342,172,509,590,627,153,270,334,194,113,40.6,881,3100,1583,1517,104.4,2939,79,0,2967,1488,1479
13103,Effingham County,GA,60477,29954,30523,98.1,4156,4787,4337,4283,3481,8310,8467,8447,4075,3231,4466,1866,571,36.0,16116,44361,21663,22698,95.4,49360,8050,534,43500,21291,22209
13105,Elbert County,GA,19166,9205,9961,92.4,1143,1053,1300,1158,1139,2189,2096,2455,1411,1338,2185,1247,452,42.6,4189,14977,7075,7902,89.5,13059,5727,109,14675,6914,7761
13107,Emanuel County,GA,22533,11047,11486,96.2,1582,1284,1871,1593,1322,3050,2760,2656,1709,1161,2127,1153,265,36.9,5628,16905,8272,8633,95.8,14069,7636,82,16453,7993,8460
13109,Evans County,GA,10687,5290,5397,98.0,748,792,852,595,493,1598,1217,1332,597,707,996,574,186,37.6,2824,7863,3713,4150,89.5,6199,3175,97,7523,3541,3982
13111,Fannin County,GA,25395,12319,13076,94.2,1006,1019,1451,1137,1209,2231,2416,3152,2074,2472,4433,2144,651,52.1,4242,21153,10116,11037,91.7,24517,63,94,20993,10075,10918
13113,Fayette County,GA,112303,54446,57857,94.1,5079,6472,8798,8984,6698,9789,12646,17169,9335,7449,12406,5407,2071,43.4,26213,86090,41023,45067,91.0,75117,25506,5037,81481,38962,42519
13115,Floyd County,GA,97369,47109,50260,93.7,5868,6117,6745,7241,6582,12354,11744,12472,6193,5993,9224,4917,1919,38.3,22680,74689,35463,39226,90.4,76218,13576,1343,70172,33036,37136
13117,Forsyth County,GA,228383,113527,114856,98.8,13858,18009,20021,17115,11311,22230,36773,37897,13860,10640,16604,8111,1954,38.5,63609,164774,80847,83927,96.3,180891,8013,29535,144507,70386,74121
13119,Franklin County,GA,22766,11116,11650,95.4,1377,1184,1563,1556,1581,2631,2415,3058,1686,1327,2636,1308,444,41.2,4980,17786,8549,9237,92.6,19429,2119,215,17242,8216,9026
13121,Fulton County,GA,1036200,501571,534629,93.8,61929,64956,63736,70187,74746,174265,148747,143376,62343,53688,72483,32929,12815,35.5,230020,806180,385079,421101,91.4,462133,456855,73129,735263,346987,388276
13123,Gilmer County,GA,30414,15178,15236,99.6,1603,1293,1904,1659,1657,2799,3248,4030,2111,2775,4637,2220,478,47.2,5942,24472,12243,12229,100.1,27832,166,137,22953,11371,11582
13125,Glascock County,GA,2996,1461,1535,95.2,125,209,202,264,155,293,382,461,196,215,279,163,52,42.7,683,2313,1066,1247,85.5,2655,306,0,2309,1066,1243
13127,Glynn County,GA,84470,39757,44713,88.9,4924,5289,5257,5034,4834,10199,9987,10650,6018,5666,10009,4523,2080,41.6,18710,65760,30349,35411,85.7,57857,22235,1099,63538,29127,34411
13129,Gordon County,GA,57202,28313,28889,98.0,3340,3414,4671,4101,3517,7118,7289,8329,3655,3521,4951,2531,765,38.4,14094,43108,20963,22145,94.7,50276,2169,637,39736,19299,20437
13131,Grady County,GA,24828,12073,12755,94.7,1371,1558,2179,1465,1322,3094,2820,3274,1873,1466,2607,1398,401,40.3,6142,18686,8835,9851,89.7,16251,7406,139,17517,8217,9300
13133,Greene County,GA,17349,8535,8814,96.8,909,938,933,841,865,1722,1661,1826,1090,1629,3160,1414,361,50.2,3296,14053,6729,7324,91.9,10246,6101,198,13597,6439,7158
13135,Gwinnett County,GA,915046,446993,468053,95.5,61117,67664,74889,68771,59556,121361,133727,135638,57963,46250,57589,23363,7158,35.3,248710,666336,320950,345386,92.9,443421,254466,106374,548900,260438,288462
13137,Habersham County,GA,44626,21134,23492,90.0,2606,2479,3149,3091,3017,5239,5446,5796,2802,2756,4833,2814,598,39.7,10018,34608,16052,18556,86.5,38434,1435,864,32261,14836,17425
13139,Hall County,GA,198667,98831,99836,99.0,13101,13738,15060,13949,13131,25818,25146,26786,12269,10757,17203,9035,2674,36.7,50926,147741,72604,75137,96.6,170110,14345,3538,126231,61056,65175
13141,Hancock County,GA,8515,4816,3699,130.2,332,311,333,363,586,1346,922,1111,736,571,1154,586,164,45.6,1184,7331,4158,3173,131.0,2080,6235,31,7216,4050,3166
13143,Haralson County,GA,29227,14126,15101,93.5,1839,1763,2274,1856,1580,3771,3397,4421,1571,2147,2738,1449,421,40.4,7062,22165,10664,11501,92.7,26978,1481,120,22080,10599,11481
13145,Harris County,GA,34105,17143,16962,101.1,1701,1957,2312,2348,1875,3442,4076,5102,2545,2584,4043,1676,444,42.9,7464,26641,13218,13423,98.5,27006,5495,364,26388,13141,13247
13147,Hart County,GA,25773,12664,13109,96.6,1369,1496,1632,1382,1253,3108,2944,3315,1761,1885,3209,1861,558,44.1,5329,20444,9966,10478,95.1,19950,4998,255,20261,9832,10429
13149,Heard County,GA,11736,5796,5940,97.6,656,715,789,760,723,1300,1446,1707,849,838,1200,503,250,41.9,2666,9070,4387,4683,93.7,10198,1024,62,8939,4336,4603
13151,Henry County,GA,225356,107505,117851,91.2,12983,16031,17680,18430,14667,27041,31424,34774,14893,11857,16538,6537,2501,36.9,58650,166706,77598,89108,87.1,107871,99006,7519,160839,74794,86045
13153,Houston County,GA,153507,74436,79071,94.1,10304,11059,11478,10000,10193,22601,20318,19965,10037,8492,11201,5740,2119,35.4,39387,114120,54250,59870,90.6,92662,47637,5065,110136,52357,57779
13155,Irwin County,GA,9320,4904,4416,111.1,423,575,659,935,490,963,1220,1238,482,594,967,625,149,39.7,2052,7268,3801,3467,109.6,6503,2674,38,7229,3762,3467
13157,Jackson County,GA,67885,33636,34249,98.2,4449,5032,4810,4439,3298,8905,9318,9780,4128,3947,6036,2924,819,38.1,17259,50626,24834,25792,96.3,58699,4625,1211,48851,23876,24975
13159,Jasper County,GA,13916,6730,7186,93.7,773,893,1071,849,686,1531,1679,1946,1006,1041,1476,743,222,43.0,3241,10675,5103,5572,91.6,10496,2838,41,10449,5018,5431
13161,Jeff Davis County,GA,15036,7347,7689,95.6,1027,1089,1261,1159,765,1966,1940,1758,818,979,1436,680,158,36.6,4010,11026,5284,5742,92.0,11601,2515,34,10719,5041,5678
13163,Jefferson County,GA,15618,7522,8096,92.9,950,929,1142,1002,950,1872,1822,2015,1089,1041,1718,805,283,40.0,3691,11927,5663,6264,90.4,6796,8325,49,11732,5519,6213
13165,Jenkins County,GA,8793,4094,4699,87.1,586,778,396,326,860,666,919,1345,779,571,1186,230,151,44.3,1968,6825,2999,3826,78.4,5207,3070,98,6543,2869,3674
13167,Johnson County,GA,9691,5505,4186,131.5,548,652,314,600,608,1042,1542,1302,589,738,1095,401,260,41.8,1867,7824,4524,3300,137.1,6218,3214,21,7814,4514,3300
13169,Jones County,GA,28579,13728,14851,92.4,1459,2247,1711,2028,1491,3175,3606,4091,1964,1840,2966,1552,449,40.4,6693,21886,10458,11428,91.5,20836,7043,213,21747,10380,11367
13171,Lamar County,GA,18672,9111,9561,95.3,1084,817,1244,1908,1475,2117,2193,2245,1337,1125,1953,827,347,37.8,3901,14771,6956,7815,89.0,12363,5489,90,14642,6867,7775
13173,Lanier County,GA,10380,5028,5352,93.9,752,572,854,667,685,1592,1421,1165,615,623,806,336,292,35.6,2617,7763,3802,3961,96.0,7683,2532,21,7720,3789,3931
13175,Laurens County,GA,47405,22431,24974,89.8,3123,3280,3382,3084,2797,5707,5753,5957,3462,2685,4590,2760,825,38.9,11719,35686,16337,19349,84.4,27786,17687,538,35371,16205,19166
13177,Lee County,GA,29502,14736,14766,99.8,1787,2192,2451,2082,1654,3739,4411,3961,1854,1680,2510,936,245,37.2,7816,21686,10736,10950,98.0,21662,6121,723,21462,10594,10868
13179,Liberty County,GA,61349,31138,30211,103.1,6262,4239,4624,3692,7030,11948,6745,5699,2990,2738,3534,1496,352,28.4,17282,44067,22241,21826,101.9,28086,25265,1260,42692,21891,20801
13181,Lincoln County,GA,7856,3675,4181,87.9,400,423,496,427,346,750,914,956,585,733,1099,649,78,47.1,1507,6349,3066,3283,93.4,5295,2433,0,6307,3040,3267
13183,Long County,GA,18692,9457,9235,102.4,1401,1600,1470,1514,993,3015,2767,2264,1162,814,1079,514,99,32.9,5273,13419,6767,6652,101.7,11937,4660,203,12659,6376,6283
13185,Lowndes County,GA,115364,56144,59220,94.8,8157,7891,7443,8943,14821,17542,12876,12234,6351,5403,8157,4051,1495,30.5,27682,87682,42057,45625,92.2,65740,42096,2011,85847,41184,44663
13187,Lumpkin County,GA,32402,15737,16665,94.4,1409,1882,1556,3214,3924,3608,3366,3629,2101,2254,3433,1607,419,37.0,5931,26471,12810,13661,93.8,30546,672,267,25797,12536,13261
13189,McDuffie County,GA,21455,9827,11628,84.5,1417,1597,1385,1449,1491,2525,2298,2649,1398,1536,2277,1085,348,37.7,5421,16034,7286,8748,83.3,11585,8561,95,15807,7132,8675
13191,McIntosh County,GA,14174,7128,7046,101.2,476,659,799,705,478,1654,1286,2033,1209,1236,2306,1146,187,49.4,2379,11795,5719,6076,94.1,8826,5036,189,11743,5719,6024
13193,Macon County,GA,13305,7262,6043,120.2,579,754,683,887,875,1996,1668,1737,955,970,1420,535,246,40.3,2554,10751,5998,4753,126.2,4558,8178,52,10590,5937,4653
13195,Madison County,GA,29218,14346,14872,96.5,1690,2254,1716,1597,1814,3452,3701,4048,2090,1991,3021,1346,498,41.1,6731,22487,10942,11545,94.8,24637,3108,112,21921,10618,11303
13197,Marion County,GA,8432,4031,4401,91.6,422,689,351,610,308,849,1009,1107,783,562,1048,584,110,44.6,1821,6611,3196,3415,93.6,5191,2602,77,6510,3143,3367
13199,Meriwether County,GA,21106,10234,10872,94.1,1254,1078,1437,1476,1046,2444,2332,2707,1452,1689,2486,1252,453,42.3,4574,16532,7844,8688,90.3,12102,8426,52,16403,7748,8655
13201,Miller County,GA,5787,2806,2981,94.1,331,326,408,382,231,757,605,747,465,283,634,477,141,43.5,1333,4454,2082,2372,87.8,3940,1765,0,4435,2078,2357
13205,Mitchell County,GA,22244,11535,10709,107.7,1291,1385,1565,1335,1429,2933,2968,2881,1540,1338,2067,1184,328,39.0,5115,17129,8980,8149,110.2,10929,10342,44,16636,8624,8012
13207,Monroe County,GA,27171,13586,13585,100.0,1334,1305,1955,1713,1804,3002,3209,3765,1967,2209,2949,1432,527,42.9,5625,21546,10613,10933,97.1,20035,6304,247,21167,10384,10783
13209,Montgomery County,GA,9058,4642,4416,105.1,502,423,533,859,706,1043,1041,1261,688,500,934,474,94,40.0,1871,7187,3694,3493,105.8,6053,2392,16,6942,3606,3336
13211,Morgan County,GA,18507,9065,9442,96.0,1046,1173,1222,1115,1131,1885,1802,2795,1374,1353,2122,1236,253,44.6,4198,14309,6854,7455,91.9,13693,4347,13,14099,6733,7366
13213,Murray County,GA,39724,19683,20041,98.2,2500,2940,2726,2612,2473,5048,5073,5723,2824,2085,3636,1730,354,38.2,9911,29813,14591,15222,95.9,38443,413,135,27815,13603,14212
13215,Muscogee County,GA,195739,95539,100200,95.3,14181,13321,13494,12823,14779,31621,24547,22805,11850,10873,14809,7221,3415,34.0,48489,147250,70639,76611,92.2,84841,90580,4840,143222,68760,74462
13217,Newton County,GA,108079,51233,56846,90.1,6920,8033,8145,8826,6887,13282,14270,15544,6516,5969,8704,3688,1295,36.4,28529,79550,36639,42911,85.4,54442,48483,1205,76973,35524,41449
13219,Oconee County,GA,38132,18737,19395,96.6,2046,2720,3417,2971,2023,3537,5244,5535,2298,2627,3577,1655,482,40.4,10146,27986,13502,14484,93.2,33718,1993,1403,26871,12972,13899
13221,Oglethorpe County,GA,14931,7559,7372,102.5,860,1067,906,935,675,1607,1914,2134,1208,807,1603,1016,199,42.4,3346,11585,5665,5920,95.7,11909,2624,32,11464,5657,5807
13223,Paulding County,GA,159825,77953,81872,95.2,10470,11209,13106,11526,10121,20558,23346,25047,9947,7816,10696,4682,1301,36.0,42530,117295,56317,60978,92.4,119808,30604,1563,113559,54344,59215
13225,Peach County,GA,27145,13203,13942,94.7,1471,1584,1713,2605,2102,3321,3063,3347,2384,1345,2558,1113,539,37.9,5751,21394,10163,11231,90.5,13261,12165,274,20586,9704,10882
13227,Pickens County,GA,31387,15557,15830,98.3,1527,1650,2042,1745,1579,3404,3571,4332,2850,1979,4261,2080,367,45.4,6370,25017,12222,12795,95.5,27993,324,134,24642,12079,12563
13229,Pierce County,GA,19250,9699,9551,101.5,1262,1420,1343,1293,970,2140,2409,2806,1169,1210,1915,1099,214,39.4,4818,14432,7051,7381,95.5,16503,1799,0,14071,6793,7278
13231,Pike County,GA,18327,8964,9363,95.7,889,1069,1477,1393,1021,2258,2285,2727,1398,973,1642,877,318,40.4,4308,14019,6726,7293,92.2,16152,1641,97,13882,6670,7212
13233,Polk County,GA,41908,20607,21301,96.7,2853,3037,3125,2858,2536,5430,5076,5336,2510,2694,3862,2064,527,37.0,10837,31071,15114,15957,94.7,33219,5035,154,29181,14053,15128
13235,Pulaski County,GA,11216,5199,6017,86.4,540,423,522,567,815,1892,1234,1426,686,882,1251,849,129,43.1,1915,9301,4125,5176,79.7,6743,4252,30,9267,4104,5163
13237,Putnam County,GA,21691,10510,11181,94.0,986,1451,1240,1185,1142,2320,2168,2738,1841,1519,3296,1548,257,46.2,4426,17265,8287,8978,92.3,14970,5689,133,16801,7989,8812
13239,Quitman County,GA,2289,1087,1202,90.4,163,103,120,87,61,373,192,207,128,285,325,192,53,47.3,454,1835,880,955,92.1,865,1188,168,1730,843,887
13241,Rabun County,GA,16645,8219,8426,97.5,734,792,706,826,892,1709,1755,2119,1106,1435,2701,1411,459,49.2,2755,13890,6850,7040,97.3,15313,449,188,13250,6544,6706
13243,Randolph County,GA,6973,3378,3595,94.0,405,762,342,559,219,639,863,649,410,622,671,480,352,41.0,1775,5198,2499,2699,92.6,2422,4351,0,5185,2493,2692
13245,Richmond County,GA,201852,97611,104241,93.6,13765,13277,12138,13944,16714,32986,23332,22935,12122,13239,16618,8145,2637,34.1,46675,155177,73869,81308,90.9,74934,113946,3809,151969,72289,79680
13247,Rockdale County,GA,89717,42245,47472,89.0,5229,6044,6811,6629,5964,10265,11312,12744,6040,6102,8104,3342,1131,38.1,22362,67355,30978,36377,85.2,34832,49114,1775,64300,29706,34594
13249,Schley County,GA,5221,2574,2647,97.2,339,245,420,360,465,594,674,721,301,265,507,240,90,37.8,1242,3979,1981,1998,99.1,3638,1328,0,3942,1970,1972
13251,Screven County,GA,13989,6801,7188,94.6,871,863,734,900,899,1578,1682,1734,1075,1099,1580,718,256,41.4,3020,10969,5284,5685,92.9,7783,5824,104,10906,5232,5674
13253,Seminole County,GA,8321,3949,4372,90.3,448,514,477,513,373,930,919,986,614,647,1129,514,257,44.9,1714,6607,3073,3534,87.0,5170,2760,65,6572,3073,3499
13255,Spalding County,GA,65306,31624,33682,93.9,3958,4914,3963,4191,3751,8542,7829,8431,4154,4044,7013,3455,1061,39.2,15545,49761,23521,26240,89.6,40803,22261,663,48838,22998,25840
13257,Stephens County,GA,25750,11981,13769,87.0,1697,1577,1394,1846,1809,3003,2510,3422,1901,1510,3242,1350,489,41.8,5759,19991,9373,10618,88.3,21785,3064,172,19799,9303,10496
13259,Stewart County,GA,6293,4187,2106,198.8,159,192,200,398,454,1710,774,813,359,297,540,248,149,35.4,769,5524,3760,1764,213.2,1483,3328,203,3468,1704,1764
13261,Sumter County,GA,30064,14197,15867,89.5,1850,2181,1752,2308,2938,3645,3236,3461,1774,1905,2977,1399,638,35.7,6921,23143,10662,12481,85.4,12836,15712,410,22336,10190,12146
13263,Talbot County,GA,6321,3051,3270,93.3,281,285,319,373,362,540,687,803,598,590,906,475,102,50.1,1088,5233,2468,2765,89.3,2606,3649,35,5225,2460,2765
13265,Taliaferro County,GA,1611,793,818,96.9,54,45,86,101,90,236,213,170,104,106,246,99,61,44.2,241,1370,693,677,102.4,547,1000,12,1329,684,645
13267,Tattnall County,GA,25382,14924,10458,142.7,1325,1539,1471,1321,1846,4268,3754,3277,1757,1304,2087,1086,347,37.3,5207,20175,12138,8037,151.0,14907,7446,48,19215,11593,7622
13269,Taylor County,GA,8116,3863,4253,90.8,409,413,518,548,569,713,830,1294,651,590,927,394,260,45.2,1657,6459,3037,3422,88.7,4682,3081,149,6419,3009,3410
13271,Telfair County,GA,16035,9238,6797,135.9,761,711,662,1036,806,2289,2727,2114,1007,1111,1562,879,370,41.5,2684,13351,8052,5299,152.0,8349,6615,17,11421,6122,5299
13273,Terrell County,GA,8737,4166,4571,91.1,549,677,453,537,526,1068,997,1043,633,615,956,468,215,41.1,2032,6705,3155,3550,88.9,3164,5220,271,6547,3081,3466
13275,Thomas County,GA,44630,21262,23368,91.0,2816,2700,3288,2834,2600,5473,5142,5821,3075,3029,4602,2346,904,40.4,10649,33981,15736,18245,86.2,26765,16240,74,33286,15417,17869
13277,Tift County,GA,40541,19674,20867,94.3,2826,2829,2777,3250,3069,5085,5228,4684,2739,2195,3445,1820,594,36.2,10077,30464,14379,16085,89.4,26142,12007,559,28863,13347,15516
13279,Toombs County,GA,26972,12476,14496,86.1,1906,1842,2234,1841,1602,3446,3245,3168,1555,1776,2455,1249,653,36.4,7165,19807,9157,10650,86.0,17156,6961,245,18851,8686,10165
13281,Towns County,GA,11617,5464,6153,88.8,386,357,412,925,1053,882,785,1134,877,810,2183,1299,514,54.0,1439,10178,4726,5452,86.7,11140,173,60,10106,4661,5445
13283,Treutlen County,GA,6795,3495,3300,105.9,409,401,411,473,393,798,784,839,540,339,820,482,106,40.1,1465,5330,2723,2607,104.4,4960,1792,0,5214,2663,2551
13285,Troup County,GA,69919,33401,36518,91.5,4562,4171,5655,4798,5013,9433,8534,8958,4746,3931,6128,2851,1139,36.4,17260,52659,24674,27985,88.2,40778,25307,1586,50896,23726,27170
13287,Turner County,GA,7943,3801,4142,91.8,531,474,608,451,316,926,1174,924,484,508,1016,379,152,40.3,1934,6009,2897,3112,93.1,4550,3241,61,5900,2842,3058
13289,Twiggs County,GA,8229,4038,4191,96.3,430,480,430,375,339,1129,838,1000,598,808,1011,705,86,45.7,1597,6632,3220,3412,94.4,4589,3526,17,6562,3188,3374
13291,Union County,GA,23288,11350,11938,95.1,962,1125,994,1086,974,2129,1938,2671,1835,2006,4446,2434,688,54.3,3803,19485,9368,10117,92.6,22580,173,72,19091,9070,10021
13293,Upson County,GA,26236,12482,13754,90.8,1768,1278,2019,1676,1566,2845,3101,3552,1915,1797,2780,1494,445,42.1,6108,20128,9372,10756,87.1,17868,7290,119,19880,9271,10609
13295,Walker County,GA,69039,34210,34829,98.2,3872,4420,3996,4315,3890,8241,8515,9592,4649,4910,7239,4190,1210,41.4,15129,53910,26134,27776,94.1,63519,2840,565,53464,25918,27546
13297,Walton County,GA,91442,44379,47063,94.3,5594,6127,6983,6434,5411,10990,11596,13239,5951,5257,8439,3986,1435,38.7,22875,68567,32810,35757,91.8,70869,16177,1255,67079,32239,34840
13299,Ware County,GA,35593,17921,17672,101.4,2241,2588,2073,2143,2070,4931,4314,4563,2253,2403,3427,1820,767,39.5,8395,27198,13672,13526,101.1,23071,10739,374,26955,13541,13414
13301,Warren County,GA,5297,2469,2828,87.3,279,396,262,197,264,671,570,661,411,443,657,337,149,45.1,1102,4195,1958,2237,87.5,1986,3237,32,4150,1922,2228
13303,Washington County,GA,20436,10465,9971,105.0,1146,1121,1354,1329,1214,2590,2461,2703,1490,1411,2135,1074,408,41.5,4381,16055,8232,7823,105.2,8909,10856,137,15843,8088,7755
13305,Wayne County,GA,29788,14998,14790,101.4,1979,2165,2034,1974,1610,3715,3900,4063,1893,1798,2913,1331,413,38.9,7365,22423,11396,11027,103.3,22251,6127,182,21956,11143,10813
13307,Webster County,GA,2610,1272,1338,95.1,59,170,280,164,61,268,294,429,199,163,315,176,32,45.1,633,1977,927,1050,88.3,1390,971,0,1961,927,1034
13309,Wheeler County,GA,7928,5012,2916,171.9,251,324,439,713,777,1239,964,1165,472,467,708,334,75,38.8,1344,6584,4197,2387,175.8,4465,3440,0,6575,4190,2385
13311,White County,GA,29489,14398,15091,95.4,1286,1560,1729,2116,1832,3022,3063,4113,2461,1802,3854,2022,629,46.1,5822,23667,11519,12148,94.8,27699,430,171,23437,11371,12066
13313,Whitfield County,GA,104237,51688,52549,98.4,6951,7977,7650,7546,6957,14048,13310,13830,5977,5698,8376,4508,1409,36.0,27351,76886,37786,39100,96.6,92420,4011,1536,63531,31501,32030
13315,Wilcox County,GA,8824,5286,3538,149.4,462,515,456,481,544,1243,1367,1127,553,608,832,470,166,39.8,1663,7161,4405,2756,159.8,5567,3131,0,6892,4151,2741
13317,Wilkes County,GA,9844,4771,5073,94.0,551,543,576,775,471,927,1071,1219,754,707,1237,713,300,45.1,2106,7738,3582,4156,86.2,5182,4193,38,7565,3514,4051
13319,Wilkinson County,GA,9010,4273,4737,90.2,500,532,679,646,406,928,1111,1145,671,704,957,500,231,42.6,2070,6940,3276,3664,89.4,5333,3509,0,6791,3216,3575
13321,Worth County,GA,20494,9871,10623,92.9,1234,1421,1168,1174,1274,2592,2142,2643,1479,1523,2316,1243,285,41.6,4616,15878,7487,8391,89.2,14049,5741,162,15759,7446,8313
15001,Hawaii County,HI,199459,99002,100457,98.6,11899,12354,12092,11014,10423,23840,23380,23501,13783,16901,25465,10237,4570,42.7,43241,156218,76813,79405,96.7,66493,1266,44971,144532,71686,72846
15003,Honolulu County,HI,984821,496066,488755,101.5,62695,57077,57575,53514,71863,150727,124587,119237,60462,56715,92099,49259,29011,37.9,209223,775598,388553,387045,100.4,206218,23603,420093,705780,361352,344428
15005,Kalawao County,HI,66,30,36,83.3,1,0,0,3,0,5,9,8,22,7,3,4,4,57.4,1,65,29,36,80.6,16,2,14,64,28,36
15007,Kauai County,HI,71769,35529,36240,98.0,4340,4698,4226,3920,3533,8776,8798,9217,5052,5350,8378,3859,1622,42.6,15755,56014,27423,28591,95.9,23229,309,23698,51124,25282,25842
15009,Maui County,HI,165979,82633,83346,99.1,9907,10723,9722,9261,8249,20959,22202,22058,12682,11121,17976,7815,3304,41.2,36418,129561,63877,65684,97.2,58891,845,48579,116890,58048,58842
16001,Ada County,ID,456849,228886,227963,100.4,26723,29763,33578,31299,27631,65774,64053,59268,28640,26386,39443,17758,6533,37.0,109797,347052,172767,174285,99.1,413350,6274,11617,335552,166823,168729
16003,Adams County,ID,4097,2112,1985,106.4,153,211,210,177,137,361,340,447,415,437,765,368,76,55.2,701,3396,1753,1643,106.7,3911,16,0,3374,1744,1630
16005,Bannock County,ID,85765,42727,43038,99.3,6220,6187,6379,6535,6178,12889,10689,8914,4997,4960,7196,3339,1282,33.8,22589,63176,31174,32002,97.4,76327,603,1688,61102,29927,31175
16007,Bear Lake County,ID,6000,2958,3042,97.2,411,527,357,423,306,635,700,611,389,406,722,362,151,39.6,1584,4416,2179,2237,97.4,5659,53,40,4365,2161,2204
16009,Benewah County,ID,9138,4620,4518,102.3,529,560,600,551,415,834,947,1113,687,874,1270,572,186,46.2,2064,7074,3562,3512,101.4,7916,6,29,7035,3550,3485
16011,Bingham County,ID,45839,22914,22925,100.0,3490,4290,4054,3597,2865,5290,5512,5005,2647,2794,3768,1798,729,33.6,14215,31624,15730,15894,99.0,37701,143,263,30330,15003,15327
16013,Blaine County,ID,22373,11521,10852,106.2,1165,1331,1526,1472,1020,2343,2739,3079,2035,1686,2557,995,425,43.2,4963,17410,8791,8619,102.0,21206,98,237,15193,7663,7530
16015,Boise County,ID,7378,3779,3599,105.0,240,229,484,515,163,498,721,1023,823,847,1256,411,168,54.0,1260,6118,3098,3020,102.6,7016,19,71,6020,3071,2949
16017,Bonner County,ID,43611,21751,21860,99.5,2125,2424,2544,2456,1801,4088,4848,5298,3525,4141,6685,2858,818,47.9,8713,34898,17355,17543,98.9,41441,127,298,34467,17190,17277
16019,Bonneville County,ID,114392,57322,57070,100.4,9713,10143,9881,8314,7068,15716,14528,11852,6027,6215,8871,4326,1738,32.9,35371,79021,39046,39975,97.7,102331,583,1169,76019,37363,38656
16021,Boundary County,ID,11845,5921,5924,99.9,747,807,710,836,589,1066,1281,1431,897,962,1589,652,278,43.5,2793,9052,4473,4579,97.7,11145,63,144,8827,4380,4447
16023,Butte County,ID,2581,1359,1222,111.2,152,233,156,86,42,333,287,257,243,256,304,129,103,45.2,595,1986,1036,950,109.1,2567,4,0,1979,1031,948
16025,Camas County,ID,1048,497,551,90.2,74,95,68,61,18,98,115,108,79,135,136,48,13,44.5,271,777,375,402,93.3,1045,0,0,763,366,397
16027,Canyon County,ID,217633,107672,109961,97.9,16407,17333,18615,16751,14637,28865,27691,25044,12136,10925,18023,8366,2840,33.6,62791,154842,75814,79028,95.9,180081,893,1846,144933,70737,74196
16029,Caribou County,ID,6953,3570,3383,105.5,466,611,580,506,386,718,885,750,482,411,653,390,115,36.9,2039,4914,2501,2413,103.6,6636,0,4,4792,2416,2376
16031,Cassia County,ID,23690,12047,11643,103.5,1948,2101,2270,1909,1469,2823,2851,2428,1291,1340,1859,988,413,32.9,7605,16085,8126,7959,102.1,22067,52,139,14224,6992,7232
16033,Clark County,ID,913,480,433,110.9,67,87,51,102,56,128,82,125,13,67,102,33,0,33.2,265,648,347,301,115.3,825,7,0,389,226,163
16035,Clearwater County,ID,8673,4831,3842,125.7,311,359,410,444,375,903,942,1139,726,751,1359,750,204,50.4,1395,7278,4044,3234,125.0,8040,46,35,7202,4007,3195
16037,Custer County,ID,4169,2147,2022,106.2,132,192,185,243,222,297,415,504,323,288,838,306,224,53.0,672,3497,1775,1722,103.1,3807,5,0,3479,1768,1711
16039,Elmore County,ID,26743,14059,12684,110.8,2113,2306,1331,1534,2695,4465,2777,3004,1582,1456,2098,1065,317,32.3,6711,20032,10612,9420,112.7,22766,720,705,18705,9914,8791
16041,Franklin County,ID,13464,6915,6549,105.6,1017,1115,1430,1189,766,1474,1736,1348,675,855,1032,650,177,32.8,4377,9087,4585,4502,101.8,12748,35,20,8870,4458,4412
16043,Fremont County,ID,13020,6752,6268,107.7,830,925,976,1089,788,1450,1645,1458,744,901,1299,659,256,37.6,3432,9588,5054,4534,111.5,12342,22,24,9010,4775,4235
16045,Gem County,ID,17331,8616,8715,98.9,977,820,1469,1055,1048,1736,1642,2232,1220,1454,2142,1285,251,44.6,4016,13315,6543,6772,96.6,15611,20,98,12918,6365,6553
16047,Gooding County,ID,15148,7773,7375,105.4,1032,1367,1019,1101,888,1712,1702,1875,1092,832,1417,736,375,38.7,4164,10984,5658,5326,106.2,14091,13,139,9530,4767,4763
16049,Idaho County,ID,16411,8629,7782,110.9,771,829,1048,860,803,1520,1508,1843,1350,1472,2625,1270,512,50.2,3217,13194,6937,6257,110.9,15319,23,66,13131,6893,6238
16051,Jefferson County,ID,28534,14526,14008,103.7,2429,2637,2960,2350,1714,3406,3729,3063,1591,1528,1938,975,214,31.5,9637,18897,9629,9268,103.9,26039,0,127,18069,9192,8877
16053,Jerome County,ID,23730,11982,11748,102.0,2030,1968,2242,1691,1388,3216,2909,2601,1380,1315,1867,742,381,32.7,7309,16421,8438,7983,105.7,22161,41,227,13347,6595,6752
16055,Kootenai County,ID,157322,77730,79592,97.7,9409,10931,9541,9778,8666,19975,19149,19270,10425,11096,17540,8730,2812,40.2,36186,121136,59059,62077,95.1,147874,494,1433,119622,58459,61163
16057,Latah County,ID,39505,20254,19251,105.2,2017,2006,2161,4016,6988,5482,3722,3736,2349,1879,3176,1477,496,28.7,7381,32124,16491,15633,105.5,36325,462,915,30572,15460,15112
16059,Lemhi County,ID,7847,3987,3860,103.3,392,495,346,411,278,655,773,823,634,743,1375,574,348,52.1,1491,6356,3236,3120,103.7,7430,3,0,6255,3224,3031
16061,Lewis County,ID,3838,1900,1938,98.0,209,249,264,214,186,333,359,411,305,361,534,356,57,48.6,868,2970,1439,1531,94.0,3327,5,53,2934,1422,1512
16063,Lincoln County,ID,5350,2805,2545,110.2,369,522,403,427,268,680,801,540,303,342,425,153,117,35.1,1584,3766,1944,1822,106.7,4978,0,22,3145,1570,1575
16065,Madison County,ID,39100,19881,19219,103.4,3847,2594,2607,4548,9159,6052,2959,2446,1248,1050,1495,729,366,23.5,10679,28421,14245,14176,100.5,36286,65,610,27364,13722,13642
16067,Minidoka County,ID,20705,10345,10360,99.9,1580,1987,1378,1513,1306,2479,2511,2143,1349,1184,1875,938,462,35.2,5909,14796,7367,7429,99.2,19373,32,55,12900,6311,6589
16069,Nez Perce County,ID,40217,19834,20383,97.3,2368,2380,2326,2446,2683,5139,4732,4679,2818,2766,4287,2329,1264,40.8,8540,31677,15537,16140,96.3,36037,143,332,31513,15441,16072
16071,Oneida County,ID,4385,2146,2239,95.8,272,413,407,293,264,345,488,428,384,250,463,240,138,38.6,1304,3081,1537,1544,99.5,4293,5,0,2987,1501,1486
16073,Owyhee County,ID,11552,5952,5600,106.3,760,880,826,875,670,1247,1335,1388,836,661,1227,592,255,38.9,3022,8530,4363,4167,104.7,9139,61,13,7744,3912,3832
16075,Payette County,ID,23260,11544,11716,98.5,1521,1839,1824,1539,1271,2342,2792,3052,1408,1512,2355,1503,302,40.4,6175,17085,8381,8704,96.3,20452,19,228,15986,7718,8268
16077,Power County,ID,7671,3881,3790,102.4,566,678,709,459,296,850,1155,733,519,503,712,370,121,38.3,2323,5348,2750,2598,105.9,6448,6,0,4586,2310,2276
16079,Shoshone County,ID,12609,6298,6311,99.8,802,680,642,663,621,1229,1390,1624,992,1150,1694,831,291,47.3,2552,10057,5003,5054,99.0,11792,43,12,9984,4966,5018
16081,Teton County,ID,11426,5972,5454,109.5,727,966,750,676,605,1474,1913,1526,814,731,875,245,124,37.2,2881,8545,4499,4046,111.2,10153,0,0,7942,4082,3860
16083,Twin Falls County,ID,84869,41795,43074,97.0,6275,6631,6926,5755,5251,11903,10553,9074,5113,4600,7163,4233,1392,34.7,23542,61327,29914,31413,95.2,77944,689,1562,57012,27878,29134
16085,Valley County,ID,10709,5411,5298,102.1,482,419,608,419,261,1165,1211,1243,887,1065,1757,650,542,50.6,1819,8890,4393,4497,97.7,10576,6,29,8869,4372,4497
16087,Washington County,ID,10057,4924,5133,95.9,493,900,567,607,369,986,1097,1088,677,798,1430,796,249,45.4,2345,7712,3773,3939,95.8,8834,19,37,7270,3522,3748
17001,Adams County,IL,66085,32276,33809,95.5,4065,4475,4057,3679,3684,8060,7657,8105,4866,4251,6853,4488,1845,41.5,14921,51164,24674,26490,93.1,61406,2731,527,50931,24576,26355
17003,Alexander County,IL,6260,2991,3269,91.5,417,381,490,333,142,715,625,820,527,478,839,376,117,45.3,1457,4803,2288,2515,91.0,3954,2094,0,4798,2288,2510
17005,Bond County,IL,16589,8582,8007,107.2,689,920,959,1044,1236,1986,2171,2132,1283,1138,1678,967,386,41.6,3161,13428,6926,6502,106.5,15077,1264,59,13222,6854,6368
17007,Boone County,IL,53537,26792,26745,100.2,3054,3207,4509,4274,3485,5732,6643,7783,3824,2692,5044,2411,879,38.5,13514,40023,19753,20270,97.4,46852,1184,632,36683,18345,18338
17009,Brown County,IL,6628,4193,2435,172.2,296,309,385,235,540,1107,1042,953,497,304,515,302,143,38.9,1142,5486,3581,1905,188.0,5265,1272,0,5397,3521,1876
17011,Bureau County,IL,33122,16334,16788,97.3,1692,1708,2331,2022,1787,3503,3697,4360,2438,2421,3871,2409,883,44.4,7097,26025,12693,13332,95.2,30937,350,291,25341,12363,12978
17013,Calhoun County,IL,4830,2420,2410,100.4,244,169,420,324,183,449,500,659,392,366,596,417,111,46.8,1009,3821,1907,1914,99.6,4719,15,43,3812,1905,1907
17015,Carroll County,IL,14466,7178,7288,98.5,770,673,854,707,799,1474,1472,1776,1129,1214,2041,1177,380,48.3,2805,11661,5806,5855,99.2,13883,179,111,11567,5781,5786
17017,Cass County,IL,12493,6236,6257,99.7,810,930,787,810,653,1563,1463,1678,903,740,1165,727,264,40.0,3043,9450,4639,4811,96.4,11058,652,45,8565,4190,4375
17019,Champaign County,IL,209922,104627,105295,99.4,11531,10825,10583,21113,33906,30456,22928,20477,10888,11256,15061,7147,3751,30.1,39585,170337,84480,85857,98.4,150820,28283,22579,154158,75734,78424
17021,Christian County,IL,32931,16644,16287,102.2,1729,1973,1857,1864,1833,3892,4082,4476,2633,2218,3357,2022,995,43.4,6746,26185,13212,12973,101.8,31774,436,208,25960,13070,12890
17023,Clark County,IL,15716,7756,7960,97.4,903,1040,1003,1013,816,1755,1772,2106,1150,1117,1643,995,403,42.3,3623,12093,5891,6202,95.0,15220,107,98,11957,5842,6115
17025,Clay County,IL,13287,6634,6653,99.7,744,833,864,817,691,1499,1508,1708,941,1021,1477,827,357,42.6,3017,10270,5064,5206,97.3,12782,107,42,10256,5055,5201
17027,Clinton County,IL,37634,19604,18030,108.7,2093,2075,2380,2187,2179,4908,4816,5299,2788,2648,3408,1956,897,40.6,7972,29662,15341,14321,107.1,35247,1298,214,29315,15127,14188
17029,Coles County,IL,51353,24877,26476,94.0,2378,2562,2802,4252,6398,6833,5439,5583,3476,3135,4697,2573,1225,35.7,9255,42098,20171,21927,92.0,47722,2019,625,41432,19770,21662
17031,Cook County,IL,5198275,2522949,2675326,94.3,322193,310091,322118,313876,342421,849085,701726,658679,330992,305924,421947,221513,97710,36.8,1145107,4053168,1940698,2112470,91.9,2946314,1217416,379444,3541181,1675471,1865710
17033,Crawford County,IL,18972,9906,9066,109.3,1017,1025,1066,1034,1054,2577,2421,2502,1339,1379,1939,1148,471,41.8,3763,15209,8020,7189,111.6,17119,1231,61,15060,7874,7186
17035,Cumberland County,IL,10836,5476,5360,102.2,684,621,783,605,528,1258,1278,1378,890,717,1176,605,313,42.5,2481,8355,4159,4196,99.1,10544,8,46,8294,4119,4175
17037,DeKalb County,IL,104366,51753,52613,98.4,6009,5682,6955,9020,15304,13967,11667,11509,6423,5148,7365,3659,1658,31.1,22523,81843,40258,41585,96.8,87649,8258,2379,77807,37951,39856
17039,De Witt County,IL,15932,7947,7985,99.5,857,927,1009,965,793,1824,1936,2165,1212,1254,1681,925,384,43.6,3443,12489,6201,6288,98.6,15305,85,4,12332,6105,6227
17041,Douglas County,IL,19623,9721,9902,98.2,1329,1201,1514,1350,1116,2447,2349,2203,1300,1369,1815,1152,478,37.8,4913,14710,7214,7496,96.2,18792,135,131,14341,6912,7429
17043,DuPage County,IL,929060,456209,472851,96.5,54850,58920,60312,61349,57946,117689,119999,129099,68485,61023,82511,39108,17769,39.3,212484,716576,347765,368811,94.3,713707,44755,110163,650008,314195,335813
17045,Edgar County,IL,17407,8540,8867,96.3,895,863,1114,987,893,1895,2028,2217,1373,1365,2095,1130,552,45.2,3529,13878,6741,7137,94.5,17212,53,31,13848,6736,7112
17047,Edwards County,IL,6455,3218,3237,99.4,367,381,456,389,346,651,746,825,524,420,742,425,183,43.5,1499,4956,2442,2514,97.1,6250,57,18,4948,2440,2508
17049,Effingham County,IL,34137,16958,17179,98.7,2261,2142,2358,2046,1951,4524,3913,4200,2354,2537,3167,1796,888,39.4,8094,26043,12825,13218,97.0,33128,231,180,25700,12690,13010
17051,Fayette County,IL,21565,11469,10096,113.6,1185,1118,1347,1235,1377,2696,2630,2855,1670,1394,2198,1376,484,41.9,4454,17111,9174,7937,115.6,20245,1007,116,17025,9108,7917
17053,Ford County,IL,13270,6551,6719,97.5,720,924,754,903,682,1470,1545,1680,980,1114,1236,722,540,43.4,3017,10253,4988,5265,94.7,12610,150,87,10206,4975,5231
17055,Franklin County,IL,38923,19195,19728,97.3,2275,2538,2252,2322,2028,4512,4638,5096,2982,2461,4370,2611,838,42.8,8618,30305,14603,15702,93.0,37716,334,206,30184,14582,15602
17057,Fulton County,IL,35092,18321,16771,109.2,1665,1862,2129,2001,1992,4251,4454,4659,2465,2569,3839,2123,1083,43.2,6962,28130,14771,13359,110.6,33002,1325,28,27823,14511,13312
17059,Gallatin County,IL,5064,2463,2601,94.7,255,247,358,292,208,534,617,643,407,312,695,383,113,45.6,1038,4026,1963,2063,95.2,4888,26,6,4020,1957,2063
17061,Greene County,IL,13132,6591,6541,100.8,666,874,684,774,798,1514,1560,1807,1053,900,1353,815,334,42.5,2729,10403,5207,5196,100.2,12723,184,27,10360,5192,5168
17063,Grundy County,IL,50666,25313,25353,99.8,3124,3756,3642,3490,2856,6499,7111,6931,3455,2921,4090,1983,808,37.9,12881,37785,18548,19237,96.4,47276,696,410,36996,18105,18891
17065,Hamilton County,IL,8176,4072,4104,99.2,447,542,494,478,425,861,947,1016,581,626,930,607,222,43.6,1812,6364,3084,3280,94.0,8114,33,12,6348,3074,3274
17067,Hancock County,IL,17983,8975,9008,99.6,966,1055,1083,1031,894,1844,1931,2280,1339,1458,2208,1224,670,46.0,3790,14193,6967,7226,96.4,17512,109,66,14121,6945,7176
17069,Hardin County,IL,3939,1968,1971,99.8,115,121,277,251,184,365,547,563,247,293,613,272,91,46.8,676,3263,1633,1630,100.2,3764,107,4,3258,1628,1630
17071,Henderson County,IL,6809,3356,3453,97.2,328,282,414,339,370,640,645,905,674,524,906,601,181,50.0,1258,5551,2711,2840,95.5,6647,9,39,5520,2699,2821
17073,Henry County,IL,49267,24536,24731,99.2,2704,2833,3363,3266,2527,5244,5909,6263,3573,3579,5581,3069,1356,43.1,11017,38250,18827,19423,96.9,46313,938,244,37698,18480,19218
17075,Iroquois County,IL,27812,13576,14236,95.4,1488,1609,1814,1751,1453,2872,3119,3564,2076,2171,3126,1888,881,44.4,6072,21740,10570,11170,94.6,25746,240,98,21226,10279,10947
17077,Jackson County,IL,57977,28661,29316,97.8,3129,2544,3055,5007,9200,8151,5869,5790,3512,3123,4954,2412,1231,31.9,10646,47331,23475,23856,98.4,44208,8723,1996,45302,22306,22996
17079,Jasper County,IL,9594,4773,4821,99.0,597,632,623,557,468,1020,1101,1270,714,785,1005,550,272,43.1,2226,7368,3632,3736,97.2,9333,47,9,7313,3590,3723
17081,Jefferson County,IL,37985,19500,18485,105.5,2403,2495,2117,2149,2349,4647,4655,4974,2552,2570,4055,2110,909,40.9,8442,29543,15244,14299,106.6,33162,3177,438,29253,15061,14192
17083,Jersey County,IL,21937,10720,11217,95.6,1043,1134,1482,1540,1479,2361,2417,3007,1610,1679,2322,1326,537,42.9,4557,17380,8329,9051,92.0,21211,96,67,17241,8299,8942
17085,Jo Daviess County,IL,21588,10864,10724,101.3,918,1120,1279,1184,956,1918,2245,2595,1566,1934,3418,1753,702,49.9,4126,17462,8658,8804,98.3,20973,123,134,17209,8516,8693
17087,Johnson County,IL,12494,6940,5554,125.0,566,713,556,657,794,1632,1504,1707,992,758,1517,755,343,43.7,2264,10230,5775,4455,129.6,10954,1408,44,10083,5638,4445
17089,Kane County,IL,531376,264564,266812,99.2,34078,36611,41608,39360,33646,63846,71557,75020,35521,30179,42350,20313,7287,37.3,137700,393676,194004,199672,97.2,387883,29416,21612,345238,168441,176797
17091,Kankakee County,IL,110637,54462,56175,97.0,6533,7067,7238,8463,8454,13498,13033,13867,7963,6513,10130,5222,2656,37.7,25509,85128,41369,43759,94.5,88023,16858,933,82329,39863,42466
17093,Kendall County,IL,126054,62117,63937,97.2,8691,10944,10458,9493,7238,15774,20433,18018,6932,5320,7988,3542,1223,35.2,36346,89708,43770,45938,95.3,102605,9339,4045,84611,40937,43674
17095,Knox County,IL,50508,25586,24922,102.7,2801,2561,2958,3371,3645,5462,5885,6124,3435,3738,5858,3248,1422,42.1,9991,40517,20317,20200,100.6,43219,4485,554,39428,19739,19689
17097,Lake County,IL,701473,350466,351007,99.8,40703,46956,51161,54555,50422,77894,88131,100799,50476,44037,57332,26661,12346,38.4,171546,529927,262804,267123,98.4,531609,47385,54157,469637,232440,237197
17099,LaSalle County,IL,109737,55245,54492,101.4,6109,6499,6660,6786,6408,13464,12826,14424,8698,7594,11082,6106,3081,41.9,23713,86024,43156,42868,100.7,101568,2937,792,84077,42093,41984
17101,Lawrence County,IL,16033,8687,7346,118.3,783,763,875,745,1011,2317,2170,2101,1296,967,1631,979,395,42.4,2894,13139,7220,5919,122.0,14073,1331,87,12922,7041,5881
17103,Lee County,IL,34389,18299,16090,113.7,1717,2144,1734,1871,1945,4238,4330,4713,2808,2378,3627,2016,868,43.2,6812,27577,14828,12749,116.3,31133,1881,193,27166,14573,12593
17105,Livingston County,IL,36040,18429,17611,104.6,1955,1922,2417,2214,2098,4358,4186,4710,2690,2672,3653,1996,1169,42.0,7762,28278,14366,13912,103.3,33377,1520,308,27824,14103,13721
17107,Logan County,IL,29003,14298,14705,97.2,1553,1475,1532,2011,2059,3844,3699,3600,2142,1864,2759,1365,1100,40.1,5607,23396,11421,11975,95.4,25667,2003,218,23162,11290,11872
17109,McDonough County,IL,30479,14845,15634,95.0,1361,1329,1721,3177,4667,3576,2826,2968,1841,1779,2873,1464,897,33.0,5223,25256,12137,13119,92.5,27372,1442,653,24666,11858,12808
17111,McHenry County,IL,307714,153295,154419,99.3,16918,20236,21804,21972,18596,34215,39059,47766,24375,19649,26745,11319,5060,40.2,73344,234370,115692,118678,97.5,284009,4481,8601,222198,109776,112422
17113,McLean County,IL,172578,83872,88706,94.6,10281,10972,9810,15030,21654,22416,20699,19950,10035,9782,12832,6029,3088,33.1,37351,135227,64976,70251,92.5,143728,14423,8797,128878,61781,67097
17115,Macon County,IL,105528,50585,54943,92.1,6503,6580,6429,6764,6551,12473,12140,12552,7337,7706,11290,6406,2797,41.1,23520,82008,38546,43462,88.7,82154,15658,1064,81120,38070,43050
17117,Macoupin County,IL,45463,22535,22928,98.3,2292,2652,2971,2810,2451,4973,5374,5996,3430,3619,4955,2583,1357,43.7,9683,35780,17423,18357,94.9,43970,434,222,35647,17400,18247
17119,Madison County,IL,264776,129045,135731,95.1,15307,16090,16785,15927,15729,35708,32126,34903,19227,18495,25017,13360,6102,40.2,58145,206631,99045,107586,92.1,231440,22999,2793,204036,97531,106505
17121,Marion County,IL,37743,18613,19130,97.3,2423,2577,2250,2174,2083,4492,4334,4687,2751,2684,4049,2154,1085,42.2,8675,29068,14124,14944,94.5,34902,1382,243,28881,14046,14835
17123,Marshall County,IL,11679,5788,5891,98.3,651,510,784,685,645,1169,1245,1507,956,866,1425,788,448,46.0,2395,9284,4549,4735,96.1,11336,34,44,9220,4535,4685
17125,Mason County,IL,13621,6708,6913,97.0,701,714,877,801,665,1403,1601,1792,1155,907,1672,908,425,45.2,2817,10804,5294,5510,96.1,13214,103,24,10791,5281,5510
17127,Massac County,IL,14219,6714,7505,89.5,791,1228,669,760,750,1471,1732,1830,940,1086,1557,1031,374,43.5,3204,11015,5219,5796,90.0,12956,830,29,10923,5163,5760
17129,Menard County,IL,12306,6031,6275,96.1,677,853,699,708,634,1260,1520,1660,990,917,1380,707,301,43.2,2694,9612,4675,4937,94.7,11942,54,43,9587,4669,4918
17131,Mercer County,IL,15589,7792,7797,99.9,812,943,952,984,763,1573,1793,2126,1308,1051,1801,1022,461,44.9,3364,12225,6075,6150,98.8,15128,98,65,12198,6053,6145
17133,Monroe County,IL,34168,16788,17380,96.6,1863,2001,2362,2139,1659,3726,4452,4776,2933,2366,3232,1840,819,42.0,7642,26526,12893,13633,94.6,33251,60,444,26332,12815,13517
17135,Montgomery County,IL,28828,15134,13694,110.5,1491,1729,1557,1507,1591,3594,3523,3938,2179,2064,2925,1941,789,43.3,5776,23052,12222,10830,112.9,27265,1078,75,22935,12135,10800
17137,Morgan County,IL,34247,17174,17073,100.6,1792,1956,1684,2215,2806,4240,3942,4158,2449,2302,3681,1994,1028,40.8,6488,27759,13922,13837,100.6,30809,2398,234,27433,13754,13679
17139,Moultrie County,IL,14641,7199,7442,96.7,958,1063,990,964,772,1684,1718,1785,866,1075,1505,839,422,40.7,3676,10965,5301,5664,93.6,14310,112,23,10875,5216,5659
17141,Ogle County,IL,51025,25310,25715,98.4,2745,3047,3555,3361,2748,5718,6109,7039,3778,3649,5247,2569,1460,42.4,11560,39465,19403,20062,96.7,48105,520,276,38140,18655,19485
17143,Peoria County,IL,182770,88617,94153,94.1,12687,11829,11997,11690,11667,25226,22076,22006,11615,11908,17145,8692,4232,37.5,43485,139285,66344,72941,91.0,132888,32480,7537,134418,63608,70810
17145,Perry County,IL,21251,11627,9624,120.8,1075,986,1269,1113,1399,2787,2885,2940,1389,1484,2221,1106,597,42.2,4039,17212,9599,7613,126.1,18779,1925,146,17087,9485,7602
17147,Piatt County,IL,16401,8076,8325,97.0,983,1033,1019,993,789,1802,2003,2112,1362,1171,1774,1009,351,42.9,3696,12705,6212,6493,95.7,15914,91,88,12592,6165,6427
17149,Pike County,IL,15672,7744,7928,97.7,968,1067,926,894,869,1812,1710,1979,1178,1044,1679,1087,459,42.0,3543,12129,5950,6179,96.3,15185,191,57,12077,5920,6157
17151,Pope County,IL,4203,2262,1941,116.5,154,188,220,120,189,314,429,598,378,463,633,301,216,52.5,626,3577,1918,1659,115.6,3893,177,24,3555,1910,1645
17153,Pulaski County,IL,5510,2717,2793,97.3,280,256,456,386,238,619,547,627,445,455,687,409,105,44.0,1206,4304,2072,2232,92.8,3620,1669,7,4277,2051,2226
17155,Putnam County,IL,5721,2962,2759,107.4,239,315,341,323,270,601,599,790,425,520,765,392,141,48.1,1115,4606,2335,2271,102.8,5532,40,46,4572,2332,2240
17157,Randolph County,IL,32295,17877,14418,124.0,1600,1686,1794,1874,1886,4314,4258,4316,2189,2407,3236,1747,988,41.6,6215,26080,14535,11545,125.9,28031,3252,190,25779,14326,11453
17159,Richland County,IL,15766,7797,7969,97.8,1051,935,1062,922,801,1797,1796,1934,1322,980,1582,1066,518,42.0,3626,12140,5960,6180,96.4,15178,125,80,12007,5883,6124
17161,Rock Island County,IL,143873,70898,72975,97.2,8987,8626,9235,9094,8800,17825,17129,17233,10024,9870,15043,8524,3483,40.1,32134,111739,54455,57284,95.1,115405,14968,3650,105717,51270,54447
17163,St. Clair County,IL,262338,126734,135604,93.5,16636,17242,17411,16468,16247,34451,33188,34328,18493,17913,22940,12013,5008,38.6,61839,200499,94908,105591,89.9,168096,78532,3861,196572,93034,103538
17165,Saline County,IL,23994,11807,12187,96.9,1498,1183,1577,1392,1231,3028,2681,3188,1638,1793,2641,1424,720,42.2,5196,18798,9048,9750,92.8,22234,632,178,18731,9022,9709
17167,Sangamon County,IL,196861,94496,102365,92.3,11385,12491,12455,12376,11582,25008,24004,25802,14637,13175,19807,10064,4075,40.3,44187,152674,71917,80757,89.1,161188,25303,4006,149783,70441,79342
17169,Schuyler County,IL,6953,3641,3312,109.9,290,285,475,385,323,730,870,1021,595,451,846,503,179,46.3,1304,5649,3004,2645,113.6,6219,625,0,5447,2879,2568
17171,Scott County,IL,5005,2437,2568,94.9,243,294,351,315,250,498,593,689,372,404,512,373,111,44.6,1096,3909,1896,2013,94.2,4886,7,4,3887,1892,1995
17173,Shelby County,IL,21737,10721,11016,97.3,1164,1265,1317,1310,1104,2287,2395,2856,1613,1625,2651,1462,688,45.1,4634,17103,8359,8744,95.6,21357,149,63,17038,8328,8710
17175,Stark County,IL,5447,2691,2756,97.6,292,330,309,353,284,550,598,700,470,369,640,400,152,45.1,1174,4273,2122,2151,98.7,5290,53,51,4241,2110,2131
17177,Stephenson County,IL,45093,21808,23285,93.7,2539,2963,2523,2511,2542,4577,4759,5808,3215,3697,5264,3199,1496,45.3,9738,35355,16893,18462,91.5,38702,4334,382,34949,16632,18317
17179,Tazewell County,IL,133195,65539,67656,96.9,7818,8859,8533,7847,6850,16271,17150,17213,9062,9216,13509,7372,3495,41.0,30374,102821,50055,52766,94.9,127484,1645,1453,101633,49496,52137
17181,Union County,IL,16968,8508,8460,100.6,935,896,1152,949,804,2000,1985,2207,1356,1214,1907,1095,468,43.7,3589,13379,6643,6736,98.6,15963,276,56,13157,6529,6628
17183,Vermilion County,IL,77563,38565,38998,98.9,5059,5123,5132,4898,4526,9169,8886,9411,5872,4957,8195,4498,1837,40.4,18438,59125,29146,29979,97.2,63747,10920,759,58210,28608,29602
17185,Wabash County,IL,11546,5666,5880,96.4,719,630,824,592,607,1330,1310,1439,892,867,1235,752,349,43.8,2566,8980,4340,4640,93.5,11062,76,112,8817,4218,4599
17187,Warren County,IL,17146,8169,8977,91.0,1003,983,1073,1536,1344,1733,2077,1945,1181,1085,1749,1064,373,39.8,3756,13390,6397,6993,91.5,15107,501,429,12750,6118,6632
17189,Washington County,IL,14058,7068,6990,101.1,786,875,829,795,671,1621,1644,1837,1177,1027,1482,988,326,43.9,3038,11020,5493,5527,99.4,13594,121,41,10983,5465,5518
17191,Wayne County,IL,16402,8110,8292,97.8,1026,930,1137,947,837,1852,1812,1993,1175,1200,1890,1100,503,43.4,3723,12679,6243,6436,97.0,15849,248,42,12615,6226,6389
17193,White County,IL,13868,6785,7083,95.8,780,895,789,767,704,1593,1529,1750,1130,938,1561,937,495,44.3,2994,10874,5282,5592,94.5,13527,97,106,10739,5200,5539
17195,Whiteside County,IL,56016,27705,28311,97.9,3187,3286,3763,3546,2946,6093,6393,7166,4086,4179,6203,3377,1791,43.4,12476,43540,21342,22198,96.1,52852,936,341,42567,20837,21730
17197,Will County,IL,689315,342031,347284,98.5,40632,46083,54004,52241,44690,80690,94513,104183,45913,39452,53074,24377,9463,37.9,174342,514973,253076,261897,96.6,506424,77941,37809,479653,235347,244306
17199,Williamson County,IL,67102,33474,33628,99.5,3936,4060,4323,3671,3527,8766,8574,8635,4439,4666,7264,3901,1340,41.2,14682,52420,25922,26498,97.8,60881,2874,785,51881,25672,26209
17201,Winnebago County,IL,284819,139039,145780,95.4,17937,18118,19206,18339,17237,35616,33684,37368,19199,19663,27901,13935,6616,39.7,67090,217729,104743,112986,92.7,224363,36935,7530,206663,99458,107205
17203,Woodford County,IL,38700,19355,19345,100.1,2344,2669,2702,2691,2236,4064,4689,5040,2645,2893,3634,2037,1056,40.5,9400,29300,14418,14882,96.9,37472,254,200,29210,14379,14831
18001,Adams County,IN,35376,17650,17726,99.6,3369,3119,2935,2560,2153,4076,3714,3910,1998,2190,2869,1623,860,33.5,11089,24287,11887,12400,95.9,34113,399,104,24166,11825,12341
18003,Allen County,IN,372575,182088,190487,95.6,26233,26798,26954,25586,24709,51279,46088,45918,23544,22515,31347,15020,6584,35.9,96307,276268,132976,143292,92.8,294017,42798,14159,264176,126688,137488
18005,Bartholomew County,IN,82481,41170,41311,99.7,5467,5770,5259,4911,5088,11721,10584,10427,5386,4634,7665,4096,1473,37.8,19771,62710,31213,31497,99.1,70299,1549,6104,56535,27570,28965
18007,Benton County,IN,8677,4332,4345,99.7,564,577,627,561,503,944,1048,1111,647,575,863,491,166,40.5,2161,6516,3182,3334,95.4,8448,43,7,6448,3133,3315
18009,Blackford County,IN,12013,5965,6048,98.6,637,790,710,698,675,1314,1257,1628,1008,772,1418,758,348,44.0,2591,9422,4620,4802,96.2,11669,4,87,9353,4608,4745
18011,Boone County,IN,65544,32417,33127,97.9,4178,4652,5569,4373,3465,7665,9015,9726,4617,3822,5049,2391,1022,38.1,17369,48175,23368,24807,94.2,60837,1137,1943,46691,22662,24029
18013,Brown County,IN,15064,7354,7710,95.4,583,755,797,762,736,1408,1513,2107,1295,1447,2340,1061,260,50.0,2680,12384,6027,6357,94.8,14552,98,121,12292,5956,6336
18015,Carroll County,IN,20074,10085,9989,101.0,1062,1231,1298,1416,1056,2128,2448,2603,1500,1488,2250,1062,532,42.9,4482,15592,7728,7864,98.3,19284,234,41,15362,7619,7743
18017,Cass County,IN,37880,19019,18861,100.8,2337,2103,2731,2550,2353,4191,4695,5035,2871,2420,3709,1975,910,40.8,8813,29067,14438,14629,98.7,31859,441,527,26784,13204,13580
18019,Clark County,IN,116507,56860,59647,95.3,7342,6973,7718,6982,6751,16029,15733,15363,7987,7680,11139,5120,1690,39.1,26434,90073,43372,46701,92.9,102002,7854,1263,87820,42261,45559
18021,Clay County,IN,26234,12925,13309,97.1,1635,1446,1864,1611,1451,3128,3168,3407,2077,1771,2711,1411,554,41.5,6027,20207,9923,10284,96.5,25311,220,73,20140,9885,10255
18023,Clinton County,IN,32273,16067,16206,99.1,2229,2573,2223,2267,1823,3865,3810,3991,2002,2276,2795,1681,738,37.8,8460,23813,11727,12086,97.0,29558,268,113,22152,10761,11391
18025,Crawford County,IN,10569,5356,5213,102.7,589,762,629,662,538,1104,1201,1403,842,814,1261,580,184,43.0,2421,8148,4149,3999,103.8,10258,41,0,8148,4149,3999
18027,Daviess County,IN,33120,16687,16433,101.5,2600,2959,2556,2473,1967,4204,3660,3677,2103,1892,2874,1487,668,34.4,9699,23421,11638,11783,98.8,31447,652,89,22621,11208,11413
18029,Dearborn County,IN,49479,24658,24821,99.3,2550,3134,3432,3375,2719,5459,5879,7165,3623,3722,5036,2567,818,42.5,11266,38213,18857,19356,97.4,48102,431,279,38008,18785,19223
18031,Decatur County,IN,26562,13182,13380,98.5,1728,1777,1710,1853,1633,3239,3107,3535,1888,1708,2492,1483,409,39.2,6442,20120,9918,10202,97.2,25655,173,387,19848,9732,10116
18033,DeKalb County,IN,42927,21411,21516,99.5,2693,2949,3050,2715,2571,5269,5166,5851,2949,2936,4028,1850,900,39.1,10472,32455,15997,16458,97.2,41724,300,177,32201,15892,16309
18035,Delaware County,IN,115020,55549,59471,93.4,5771,5901,5697,10689,15922,12987,11481,13429,6579,7180,10801,6041,2542,35.6,21315,93705,44473,49232,90.3,101663,8056,1644,92328,43784,48544
18037,Dubois County,IN,42543,21180,21363,99.1,2830,2972,2949,2688,2486,4726,5039,5493,2899,3290,3922,2468,781,40.3,10512,32031,15810,16221,97.5,40204,571,300,31060,15315,15745
18039,Elkhart County,IN,204558,101223,103335,98.0,15475,14777,16973,14637,13011,25969,24863,25431,12739,11440,16731,8428,4084,35.6,56724,147834,72326,75508,95.8,178541,11115,2147,137894,66995,70899
18041,Fayette County,IN,23194,11402,11792,96.7,1207,1397,1525,1521,1322,2443,2832,3114,1605,1676,2612,1339,601,42.8,5129,18065,8792,9273,94.8,22352,571,8,17998,8761,9237
18043,Floyd County,IN,77320,37319,40001,93.3,4526,4556,5360,5127,4588,9598,9935,10491,5677,5337,7386,3099,1640,39.8,17622,59698,28474,31224,91.2,69863,3985,827,58952,28127,30825
18045,Fountain County,IN,16430,8254,8176,101.0,935,1102,911,1035,930,1798,1873,2336,1121,1184,1764,1074,367,43.4,3635,12795,6295,6500,96.8,16023,37,72,12663,6239,6424
18047,Franklin County,IN,22774,11230,11544,97.3,1310,1515,1624,1517,1262,2317,2641,3174,1787,1634,2334,1262,397,42.2,5439,17335,8587,8748,98.2,22199,33,205,17199,8543,8656
18049,Fulton County,IN,20096,9903,10193,97.2,1175,1566,1189,1272,1052,2264,2263,2645,1450,1421,2144,1227,428,41.3,4734,15362,7518,7844,95.8,18864,186,90,14994,7335,7659
18051,Gibson County,IN,33656,16923,16733,101.1,2079,2268,2197,2215,2089,3838,3984,4445,2584,2170,3267,1778,742,40.3,7969,25687,12712,12975,98.0,31865,740,143,25427,12636,12791
18053,Grant County,IN,66452,31695,34757,91.2,3697,3778,3940,5091,5889,7116,6881,8328,4791,4535,6846,3891,1669,40.3,13807,52645,24751,27894,88.7,58360,4811,653,52103,24470,27633
18055,Greene County,IN,32159,15971,16188,98.7,1712,1958,2038,1998,1689,3645,3717,4530,2351,2320,3506,2068,627,43.1,7068,25091,12434,12657,98.2,31405,127,64,24980,12398,12582
18057,Hamilton County,IN,323117,157702,165415,95.3,21534,23932,27452,22951,17265,38493,48528,47493,20562,16545,23515,10214,4633,37.1,88550,234567,112649,121918,92.4,280363,12764,19336,224791,108190,116601
18059,Hancock County,IN,75164,37039,38125,97.2,4369,4678,5289,5154,4192,8811,9682,10993,5656,4369,7237,3603,1131,39.8,17682,57482,27945,29537,94.6,70855,1780,604,56785,27677,29108
18061,Harrison County,IN,39940,19862,20078,98.9,2281,2426,2710,2501,2025,4560,4926,5609,3013,3011,4176,2139,563,42.3,9046,30894,15324,15570,98.4,38588,252,173,30652,15191,15461
18063,Hendricks County,IN,163799,81767,82032,99.7,9698,11345,12843,11402,9590,20427,23306,23051,10970,9339,13216,6033,2579,37.7,41412,122387,60612,61775,98.1,142553,11507,4773,119471,59170,60301
18065,Henry County,IN,48255,25389,22866,111.0,2398,2819,2811,2836,3029,5906,5899,6678,3506,3382,5174,2850,967,42.1,9877,38378,20183,18195,110.9,45659,1235,193,38229,20065,18164
18067,Howard County,IN,82331,39867,42464,93.9,4973,4917,5511,4960,4987,9713,9286,10685,5973,5636,8881,4709,2100,41.7,18650,63681,30362,33319,91.1,71866,6389,1032,63047,30014,33033
18069,Huntington County,IN,36359,17919,18440,97.2,2038,2131,2305,2434,2432,4407,4324,4803,2747,2610,3418,1977,733,40.7,7831,28528,13965,14563,95.9,34850,357,263,28195,13745,14450
18071,Jackson County,IN,44025,21842,22183,98.5,2895,3038,2981,2777,2362,5605,5872,5770,2979,2768,4011,1958,1009,38.5,10781,33244,16274,16970,95.9,40013,473,983,32009,15505,16504
18073,Jasper County,IN,33447,16731,16716,100.1,1930,2304,2096,2495,2090,3697,4098,4303,2458,2193,3449,1750,584,40.3,7878,25569,12611,12958,97.3,31527,204,110,25006,12307,12699
18075,Jay County,IN,20840,10452,10388,100.6,1459,1329,1555,1428,1324,2277,2281,2791,1318,1463,2067,1136,412,39.7,5279,15561,7659,7902,96.9,20212,76,157,15459,7636,7823
18077,Jefferson County,IN,32201,15332,16869,90.9,2025,1675,1735,2187,2268,3897,3803,4332,2614,2075,3322,1674,594,40.8,6634,25567,11994,13573,88.4,30433,679,286,25371,11905,13466
18079,Jennings County,IN,27710,13964,13746,101.6,1734,1695,1812,1778,1729,3180,3294,4196,1758,2122,2688,1397,327,39.8,6418,21292,10725,10567,101.5,26750,395,63,21087,10649,10438
18081,Johnson County,IN,153716,75493,78223,96.5,9888,11155,10559,10173,9474,20460,20779,20503,9361,9214,13206,6849,2095,37.5,38279,115437,55881,59556,93.8,139922,3801,5192,112116,54361,57755
18083,Knox County,IN,37065,18817,18248,103.1,2184,2680,1650,3074,2967,4368,4128,4445,2775,2300,3631,2250,613,37.9,7945,29120,14675,14445,101.6,34881,1036,336,28852,14481,14371
18085,Kosciusko County,IN,79035,39472,39563,99.8,5123,5358,5317,5264,5147,10262,9081,9854,5671,5131,7528,4090,1209,38.5,19073,59962,29694,30268,98.1,74170,589,995,57600,28312,29288
18087,LaGrange County,IN,39193,19811,19382,102.2,3630,3206,3839,3207,2680,4562,4207,4248,1949,2406,3101,1675,483,31.1,12844,26349,13208,13141,100.5,38347,75,35,25941,12947,12994
18089,Lake County,IN,485707,234929,250778,93.7,29351,31024,33711,32906,30853,59383,61133,62345,34767,32130,44869,22850,10385,39.1,114937,370770,176382,194388,90.7,300770,114891,6911,357655,169460,188195
18091,LaPorte County,IN,110154,56741,53413,106.2,6516,6258,6845,6561,6752,14351,13576,14643,7917,7636,11482,5748,1869,40.3,23780,86374,44691,41683,107.2,91260,12169,639,84981,43848,41133
18093,Lawrence County,IN,45548,22485,23063,97.5,2469,2956,2749,2804,2407,5096,5405,6238,3367,3051,5209,2748,1049,43.1,9989,35559,17304,18255,94.8,43954,180,223,35233,17193,18040
18095,Madison County,IN,129455,64666,64789,99.8,7368,7487,8331,8251,7938,16212,16071,17296,8748,8527,13428,6850,2948,40.4,28229,101226,50030,51196,97.7,113506,10255,663,99659,49254,50405
18097,Marion County,IN,951869,458696,493173,93.0,69636,66821,62417,59302,67291,159452,122197,113985,60660,53302,68988,32982,14836,34.3,235320,716549,338281,378268,89.4,587672,266137,31377,661649,308711,352938
18099,Marshall County,IN,46461,23189,23272,99.6,2947,3354,3274,3408,2743,5028,5380,6035,3122,3142,4451,2415,1162,40.0,11779,34682,17047,17635,96.7,43518,358,217,33143,16111,17032
18101,Martin County,IN,10212,5158,5054,102.1,619,491,746,718,518,1117,1184,1334,754,780,1123,577,251,42.7,2276,7936,3956,3980,99.4,10025,77,18,7930,3956,3974
18103,Miami County,IN,35815,19028,16787,113.3,1877,2166,2242,2155,2420,4666,4553,4858,2664,2016,3651,1851,696,40.1,7677,28138,15085,13053,115.6,32391,1934,208,27886,14911,12975
18105,Monroe County,IN,146461,72846,73615,99.0,6418,6464,6147,15941,26995,21130,15283,14375,7589,7656,10869,4974,2620,29.6,23112,123349,60955,62394,97.7,126086,4469,9784,115373,56578,58795
18107,Montgomery County,IN,38287,19388,18899,102.6,2262,2399,2510,2578,2518,4450,4303,5051,2853,2553,3771,2403,636,40.2,8685,29602,14951,14651,102.0,36484,277,314,28793,14438,14355
18109,Morgan County,IN,69922,34624,35298,98.1,4036,4020,4897,4599,4126,7842,8218,10336,5706,4771,6987,3189,1195,41.5,15991,53931,26464,27467,96.3,67978,285,585,53567,26383,27184
18111,Newton County,IN,13992,6989,7003,99.8,742,787,940,873,743,1583,1723,1805,1099,1050,1511,898,238,43.1,2995,10997,5528,5469,101.1,13617,33,0,10735,5391,5344
18113,Noble County,IN,47506,23872,23634,101.0,3130,3167,3601,3232,2856,5665,5753,6267,3453,3149,4445,1934,854,38.7,11988,35518,17668,17850,99.0,45774,228,314,34082,16911,17171
18115,Ohio County,IN,5874,2922,2952,99.0,301,383,245,321,245,634,658,823,617,415,723,428,81,47.4,1129,4745,2346,2399,97.8,5694,23,26,4728,2346,2382
18117,Orange County,IN,19545,9805,9740,100.7,1171,1098,1389,1266,1060,2122,2218,2580,1441,1503,2185,1109,403,42.4,4506,15039,7445,7594,98.0,18668,500,99,14919,7366,7553
18119,Owen County,IN,20835,10636,10199,104.3,1124,1149,1297,1271,1035,2219,2288,3051,1880,1571,2479,1123,348,45.2,4416,16419,8387,8032,104.4,20191,98,103,16312,8342,7970
18121,Parke County,IN,16946,8170,8776,93.1,1050,1005,970,921,964,2067,1869,2268,1253,1340,1952,1020,267,43.2,3638,13308,6277,7031,89.3,16145,99,0,13176,6181,6995
18123,Perry County,IN,19102,10191,8911,114.4,1083,989,1344,1007,1064,2520,2424,2419,1467,1317,2010,1002,456,42.0,4083,15019,8095,6924,116.9,18091,577,97,14938,8046,6892
18125,Pike County,IN,12378,6176,6202,99.6,696,785,819,771,594,1315,1409,1659,913,980,1389,761,287,43.7,2831,9547,4781,4766,100.3,11979,109,111,9508,4758,4750
18127,Porter County,IN,168636,83467,85169,98.0,9172,10405,10734,11623,11056,20523,22081,22201,12213,11736,16305,7427,3160,39.5,37505,131131,64142,66989,95.8,153462,6386,2350,128836,62919,65917
18129,Posey County,IN,25560,12744,12816,99.4,1392,1485,1722,1654,1374,2864,2996,3360,2188,1871,2740,1373,541,42.6,5720,19840,9811,10029,97.8,24599,458,84,19762,9785,9977
18131,Pulaski County,IN,12559,6330,6229,101.6,649,847,846,760,738,1369,1480,1622,960,914,1349,764,261,41.6,2871,9688,4886,4802,101.7,11940,24,81,9639,4861,4778
18133,Putnam County,IN,37384,19760,17624,112.1,1863,1987,2126,3046,3552,4380,4368,4939,2726,2274,3384,2021,718,37.9,7288,30096,15977,14119,113.2,34845,955,926,29351,15473,13878
18135,Randolph County,IN,24926,12214,12712,96.1,1450,1472,1736,1623,1324,2696,2921,3284,1815,1698,2673,1530,704,42.6,5739,19187,9355,9832,95.1,23663,147,27,18894,9196,9698
18137,Ripley County,IN,28391,14040,14351,97.8,1647,1872,1950,1963,1715,3093,3351,3935,2160,1780,2809,1538,578,40.7,6748,21643,10569,11074,95.4,27613,111,275,21395,10421,10974
18139,Rush County,IN,16641,8092,8549,94.7,927,874,1199,1137,988,1767,1934,2357,1352,1132,1636,1015,323,41.7,3768,12873,6249,6624,94.3,16173,280,19,12790,6203,6587
18141,St. Joseph County,IN,270216,131381,138835,94.6,17380,17329,18218,20423,20695,35709,31805,32501,16601,17946,23720,11421,6468,36.6,64031,206185,98611,107574,91.7,210451,34857,6585,196907,93716,103191
18143,Scott County,IN,23759,11681,12078,96.7,1424,1353,1621,1472,1441,2806,2867,3495,1738,1595,2451,945,551,41.5,5318,18441,9067,9374,96.7,23171,48,117,18228,8944,9284
18145,Shelby County,IN,44438,21874,22564,96.9,2534,2465,3369,2746,2440,5445,5205,6291,3490,3053,4257,2085,1058,40.8,10134,34304,16745,17559,95.4,42110,519,250,33574,16391,17183
18147,Spencer County,IN,20447,10264,10183,100.8,1118,1203,1379,1283,1070,2201,2310,2826,1656,1461,2324,1110,506,44.0,4526,15921,7972,7949,100.3,19905,143,69,15758,7881,7877
18149,Starke County,IN,22952,11422,11530,99.1,1296,1480,1610,1511,1258,2593,2712,2939,1662,1802,2476,1222,391,41.5,5407,17545,8689,8856,98.1,22303,198,60,17394,8618,8776
18151,Steuben County,IN,34453,17548,16905,103.8,1881,1845,2029,2391,2548,3574,3583,4687,2625,2544,4109,1903,734,43.7,7069,27384,13881,13503,102.8,33232,114,152,27015,13764,13251
18153,Sullivan County,IN,20730,11076,9654,114.7,1058,1094,1198,1146,1320,2768,2827,2938,1617,1187,2103,1044,430,41.0,4077,16653,8976,7677,116.9,19254,830,106,16615,8947,7668
18155,Switzerland County,IN,10685,5533,5152,107.4,650,921,602,723,536,1128,1315,1483,668,765,1100,632,162,40.5,2686,7999,4040,3959,102.0,10307,102,41,7959,4000,3959
18157,Tippecanoe County,IN,191553,97798,93755,104.3,11316,10820,10914,19391,33286,27201,20152,18709,8839,9603,12477,6089,2756,28.2,39460,152093,77797,74296,104.7,156081,10168,15564,135440,67841,67599
18159,Tipton County,IN,15162,7538,7624,98.9,804,895,811,962,862,1567,1653,2219,1421,893,1756,927,392,45.1,3154,12008,5959,6049,98.5,14586,16,48,11914,5939,5975
18161,Union County,IN,7113,3480,3633,95.8,452,399,392,451,381,796,798,1081,525,499,809,411,119,43.5,1521,5592,2718,2874,94.6,6898,15,145,5486,2680,2806
18163,Vanderburgh County,IN,181291,87633,93658,93.6,10950,11123,10894,11468,12797,25831,21411,21721,12482,12848,16639,8737,4390,38.3,39346,141945,67651,74294,91.1,154112,17307,2256,139230,66263,72967
18165,Vermillion County,IN,15539,7778,7761,100.2,830,882,1059,1022,833,1626,1894,2139,1186,1046,1763,906,353,42.9,3432,12107,5939,6168,96.3,15106,182,35,12016,5859,6157
18167,Vigo County,IN,107459,54561,52898,103.1,6169,6043,6084,8171,11763,13826,12345,12859,6661,6385,9802,4988,2363,36.2,22045,85414,43033,42381,101.5,93609,7230,1987,83461,41885,41576
18169,Wabash County,IN,31389,15334,16055,95.5,1591,1521,2106,2371,2157,3330,3478,3956,2162,2316,3398,2046,957,42.3,6507,24882,12034,12848,93.7,30001,349,121,24665,11905,12760
18171,Warren County,IN,8237,4109,4128,99.5,457,510,526,470,394,871,954,1171,633,593,927,611,120,44.4,1813,6424,3204,3220,99.5,8038,47,23,6384,3179,3205
18173,Warrick County,IN,62280,30667,31613,97.0,3505,4435,4165,4180,3113,6795,7993,8696,4514,4290,6293,3209,1092,41.2,14950,47330,23164,24166,95.9,58364,1028,1660,46252,22586,23666
18175,Washington County,IN,27848,13885,13963,99.4,1603,1634,1954,1789,1539,3163,3405,3944,1981,2179,2790,1443,424,41.6,6370,21478,10700,10778,99.3,27291,26,95,21455,10696,10759
18177,Wayne County,IN,66342,32240,34102,94.5,3858,3981,4240,4428,4285,7608,7635,8606,4249,4985,6848,3816,1803,40.6,14676,51666,24711,26955,91.7,59572,3378,741,50893,24299,26594
18179,Wells County,IN,28011,13734,14277,96.2,1710,1909,2066,1823,1530,3216,3238,3463,2270,1762,2782,1357,885,40.3,6904,21107,10190,10917,93.3,26818,224,115,20979,10133,10846
18181,White County,IN,24149,12063,12086,99.8,1490,1697,1510,1479,1348,2626,2560,3122,1744,1862,2718,1329,664,42.0,5650,18499,9167,9332,98.2,21955,123,55,17837,8772,9065
18183,Whitley County,IN,33730,16755,16975,98.7,2041,2152,2250,2022,1893,3864,3996,4528,2508,2533,3476,1668,799,41.8,7798,25932,12735,13197,96.5,32666,137,145,25794,12704,13090
19001,Adair County,IA,7085,3505,3580,97.9,386,430,438,377,339,806,739,869,470,665,763,521,282,45.4,1519,5566,2730,2836,96.3,6911,39,48,5480,2671,2809
19003,Adams County,IA,3670,1830,1840,99.5,219,271,157,180,181,401,363,449,274,339,445,273,118,47.3,767,2903,1433,1470,97.5,3620,2,9,2893,1431,1462
19005,Allamakee County,IA,13813,6975,6838,102.0,948,771,985,751,686,1443,1379,1651,1081,1042,1685,905,486,44.4,3194,10619,5352,5267,101.6,13324,176,79,10275,5146,5129
19007,Appanoose County,IA,12452,6138,6314,97.2,673,825,775,682,596,1315,1288,1575,864,1032,1498,876,453,45.7,2733,9719,4736,4983,95.0,12074,89,58,9656,4700,4956
19009,Audubon County,IA,5571,2770,2801,98.9,330,261,366,339,245,519,543,673,493,448,651,437,266,48.1,1146,4425,2151,2274,94.6,5401,11,15,4414,2151,2263
19011,Benton County,IA,25636,12788,12848,99.5,1575,1514,1840,1650,1306,2630,3076,3595,1981,1838,2471,1507,653,42.6,6052,19584,9723,9861,98.6,24852,143,85,19484,9687,9797
19013,Black Hawk County,IA,132393,65087,67306,96.7,8396,8025,7796,9461,14997,17231,14858,14157,8054,8280,11805,6399,2934,35.2,28685,103708,50415,53293,94.6,110821,12534,3145,99358,47944,51414
19015,Boone County,IA,26370,13203,13167,100.3,1521,1676,1459,1630,1538,3202,3270,3360,1945,2104,2646,1335,684,41.8,5724,20646,10214,10432,97.9,25246,168,82,20479,10141,10338
19017,Bremer County,IA,24864,12313,12551,98.1,1465,1471,1600,2046,1854,2609,2917,2901,1682,1453,2596,1601,669,39.8,5538,19326,9408,9918,94.9,23895,228,286,19163,9321,9842
19019,Buchanan County,IA,21118,10432,10686,97.6,1475,1590,1635,1383,1030,2374,2501,2523,1445,1393,2135,1092,542,39.1,5649,15469,7603,7866,96.7,20564,36,54,15400,7579,7821
19021,Buena Vista County,IA,20058,9999,10059,99.4,1497,1505,1292,1611,1589,2519,2196,2158,1412,1252,1595,819,613,35.0,5194,14864,7403,7461,99.2,15451,505,2020,12295,6074,6221
19023,Butler County,IA,14628,7291,7337,99.4,792,887,1116,889,663,1420,1661,1795,1075,1062,1714,1064,490,43.9,3408,11220,5497,5723,96.1,14262,153,31,11213,5497,5716
19025,Calhoun County,IA,9744,5057,4687,107.9,567,544,609,516,511,1074,1099,1098,630,874,1092,725,405,44.6,2063,7681,3967,3714,106.8,9317,150,35,7636,3943,3693
19027,Carroll County,IA,20281,10005,10276,97.4,1306,1483,1311,1279,1140,2078,2263,2459,1562,1400,1949,1214,837,42.0,4968,15313,7390,7923,93.3,19747,19,41,15171,7319,7852
19029,Cass County,IA,13091,6457,6634,97.3,665,900,789,809,597,1292,1503,1592,931,1059,1514,914,526,44.9,2906,10185,4944,5241,94.3,12695,26,43,10053,4830,5223
19031,Cedar County,IA,18457,9179,9278,98.9,922,1299,1237,1144,904,1918,2235,2443,1307,1495,1892,1118,543,42.7,4255,14202,7001,7201,97.2,17988,260,67,14090,6941,7149
19033,Cerro Gordo County,IA,42834,20905,21929,95.3,2306,2184,2821,2584,2371,5077,4481,5224,3386,3357,4806,2728,1509,44.3,8813,34021,16381,17640,92.9,40288,747,491,33627,16158,17469
19035,Cherokee County,IA,11343,5720,5623,101.7,654,722,635,546,604,1189,1125,1270,884,1048,1287,807,572,46.3,2437,8906,4449,4457,99.8,10762,228,90,8887,4446,4441
19037,Chickasaw County,IA,12026,6090,5936,102.6,723,861,694,715,744,1156,1236,1498,1013,966,1299,816,305,44.5,2752,9274,4711,4563,103.2,11770,129,15,9122,4581,4541
19039,Clarke County,IA,9360,4588,4772,96.1,674,571,707,575,443,1024,1110,1247,642,696,913,547,211,40.5,2301,7059,3388,3671,92.3,8946,6,69,6720,3227,3493
19041,Clay County,IA,16211,7998,8213,97.4,1058,1003,1000,929,849,1776,1873,1946,1126,1322,1716,983,630,42.9,3661,12550,6141,6409,95.8,15446,112,105,12294,6035,6259
19043,Clayton County,IA,17625,8946,8679,103.1,949,1264,901,982,820,1759,1762,2189,1512,1442,2160,1268,617,47.3,3758,13867,6994,6873,101.8,17173,170,79,13638,6834,6804
19045,Clinton County,IA,46909,22958,23951,95.9,2808,2387,3662,2943,2459,5144,5336,6061,3719,3333,4895,2810,1352,42.2,10689,36220,17587,18633,94.4,43921,1320,326,35919,17446,18473
19047,Crawford County,IA,17034,8491,8543,99.4,1113,1195,1181,1227,1206,1938,1744,2194,1374,962,1514,1004,382,38.7,4228,12806,6470,6336,102.1,14619,477,353,10703,5577,5126
19049,Dallas County,IA,87099,42984,44115,97.4,6760,7255,6602,5419,4158,12813,13830,11205,4780,3920,6022,2961,1374,35.4,24336,62763,30599,32164,95.1,78883,1654,3928,59795,29072,30723
19051,Davis County,IA,8920,4403,4517,97.5,805,683,716,665,459,951,936,1006,525,619,818,489,248,36.8,2621,6299,3149,3150,100.0,8710,4,57,6280,3149,3131
19053,Decatur County,IA,7979,4009,3970,101.0,497,524,431,676,1011,732,732,787,502,520,787,523,257,36.4,1735,6244,3133,3111,100.7,7552,141,59,6109,3054,3055
19055,Delaware County,IA,17183,8626,8557,100.8,1129,1114,1150,1072,926,1627,1852,2206,1478,1353,1740,986,550,43.8,4120,13063,6512,6551,99.4,16760,36,63,13001,6461,6540
19057,Des Moines County,IA,39386,19149,20237,94.6,2297,2348,2783,2463,2066,4329,4523,4962,2556,3078,4367,2421,1193,42.9,8929,30457,14645,15812,92.6,35502,2258,302,30075,14468,15607
19059,Dickinson County,IA,17127,8519,8608,99.0,792,919,938,895,835,1719,1804,2027,1336,1488,2433,1310,631,48.4,3236,13891,6766,7125,95.0,16683,77,152,13718,6748,6970
19061,Dubuque County,IA,96982,47818,49164,97.3,6118,6194,6046,7138,6632,12231,10575,11904,6561,6805,8982,5378,2418,38.6,22203,74779,36520,38259,95.5,89785,3440,1050,73436,35767,37669
19063,Emmet County,IA,9438,4728,4710,100.4,506,460,613,1002,381,878,1040,1143,701,777,994,624,319,42.9,1959,7479,3743,3736,100.2,8929,199,24,7227,3538,3689
19065,Fayette County,IA,19803,9956,9847,101.1,1073,1247,1112,1369,1232,2117,1996,2435,1572,1491,2167,1337,655,43.8,4149,15654,7803,7851,99.4,18890,444,50,15538,7712,7826
19067,Floyd County,IA,15786,7757,8029,96.6,866,1053,1039,1041,926,1552,1627,1977,1225,1052,1828,993,607,44.1,3562,12224,5967,6257,95.4,14832,271,237,12105,5890,6215
19069,Franklin County,IA,10162,5055,5107,99.0,604,740,634,525,580,1163,1054,1193,796,764,1087,733,289,42.7,2343,7819,3844,3975,96.7,9669,25,0,7501,3678,3823
19071,Fremont County,IA,6946,3455,3491,99.0,394,380,478,372,334,645,797,843,563,593,852,472,223,46.2,1512,5434,2694,2740,98.3,6614,55,0,5384,2662,2722
19073,Greene County,IA,8950,4397,4553,96.6,517,677,483,489,480,912,950,1081,633,732,1052,591,353,44.5,2042,6908,3346,3562,93.9,8571,48,66,6849,3337,3512
19075,Grundy County,IA,12299,6087,6212,98.0,663,862,814,740,592,1336,1480,1524,941,828,1283,860,376,42.6,2835,9464,4634,4830,95.9,12080,74,34,9444,4622,4822
19077,Guthrie County,IA,10669,5278,5391,97.9,564,604,810,675,480,962,1176,1381,897,762,1273,800,285,45.5,2431,8238,4063,4175,97.3,10321,34,26,8110,3988,4122
19079,Hamilton County,IA,14997,7376,7621,96.8,918,831,1128,864,706,1658,1732,1947,1149,1040,1560,832,632,42.6,3433,11564,5676,5888,96.4,14077,202,455,11257,5485,5772
19081,Hancock County,IA,10802,5418,5384,100.6,606,648,690,647,529,1146,1213,1265,982,718,1226,687,445,44.2,2388,8414,4183,4231,98.9,10430,172,53,8290,4104,4186
19083,Hardin County,IA,17061,8522,8539,99.8,841,1047,857,1293,868,1853,1840,2153,1249,1426,1784,1183,667,44.7,3582,13479,6606,6873,96.1,16212,221,13,13229,6440,6789
19085,Harrison County,IA,14089,7030,7059,99.6,822,925,914,858,688,1472,1613,1853,1092,1116,1464,914,358,44.0,3238,10851,5385,5466,98.5,13739,27,69,10810,5375,5435
19087,Henry County,IA,19941,10133,9808,103.3,1109,1212,1267,1298,1398,2503,2301,2528,1322,1327,2052,1039,585,39.7,4360,15581,7966,7615,104.6,18273,444,526,15235,7749,7486
19089,Howard County,IA,9226,4613,4613,100.0,628,704,651,503,460,970,989,1153,669,633,964,549,353,41.5,2339,6887,3399,3488,97.4,9051,29,40,6844,3374,3470
19091,Humboldt County,IA,9554,4683,4871,96.1,571,618,702,493,469,1027,1121,1075,707,784,974,688,325,42.9,2227,7327,3602,3725,96.7,9300,38,30,7154,3538,3616
19093,Ida County,IA,6901,3442,3459,99.5,393,429,533,379,374,691,735,768,532,556,760,521,230,43.7,1619,5282,2596,2686,96.6,6713,47,16,5240,2588,2652
19095,Iowa County,IA,16189,8020,8169,98.2,948,1018,1113,953,881,1706,1996,2106,1267,1217,1483,1071,430,41.7,3720,12469,6117,6352,96.3,15664,151,80,12389,6066,6323
19097,Jackson County,IA,19401,9713,9688,100.3,1158,1223,1151,1163,1067,1903,2108,2628,1627,1416,2169,1191,597,44.3,4312,15089,7537,7552,99.8,18781,92,79,14958,7475,7483
19099,Jasper County,IA,36971,18879,18092,104.3,2165,2240,2461,2124,1954,4497,4403,4890,2560,2688,3750,2394,845,42.1,8275,28696,14690,14006,104.9,35232,738,172,28456,14549,13907
19101,Jefferson County,IA,18148,8889,9259,96.0,799,720,824,734,1435,2722,2311,1997,1240,1451,2577,891,447,42.9,2867,15281,7500,7781,96.4,15104,1305,790,13950,6732,7218
19103,Johnson County,IA,148577,73612,74965,98.2,8844,8451,8086,12533,23127,23239,17874,14803,7787,7023,10274,4355,2181,30.3,29819,118758,58667,60091,97.6,121408,10815,9271,107829,53021,54808
19105,Jones County,IA,20559,10633,9926,107.1,1034,1238,1353,1179,1080,2233,2592,2672,1739,1295,2203,1235,706,43.1,4391,16168,8421,7747,108.7,19621,435,196,16028,8374,7654
19107,Keokuk County,IA,10188,5180,5008,103.4,618,689,592,621,511,1070,1104,1210,805,774,1123,743,328,43.7,2322,7866,3946,3920,100.7,9932,46,29,7798,3902,3896
19109,Kossuth County,IA,14978,7508,7470,100.5,877,884,977,866,849,1489,1484,1681,1225,1190,1656,1179,621,45.5,3293,11685,5817,5868,99.1,14481,114,84,11566,5749,5817
19111,Lee County,IA,34227,17263,16964,101.8,2051,2071,2044,1932,1884,3911,3852,4435,2563,2679,4064,1811,930,43.1,7448,26779,13430,13349,100.6,32054,946,213,26657,13333,13324
19113,Linn County,IA,223861,110379,113482,97.3,14110,14366,14995,14798,15037,30525,28646,28571,14628,13414,19635,10202,4934,37.7,52610,171251,83456,87795,95.1,197046,12389,5086,166050,80650,85400
19115,Louisa County,IA,11178,5728,5450,105.1,633,536,854,727,712,1233,1390,1462,821,761,1129,659,261,41.9,2528,8650,4346,4304,101.0,10097,126,377,8006,4001,4005
19117,Lucas County,IA,8583,4317,4266,101.2,507,491,618,552,459,813,908,1063,705,631,964,619,253,44.2,1988,6595,3261,3334,97.8,8505,8,0,6457,3214,3243
19119,Lyon County,IA,11776,6012,5764,104.3,869,1054,866,795,571,1246,1477,1273,820,702,1050,651,402,38.0,3330,8446,4230,4216,100.3,11383,10,30,8311,4159,4152
19121,Madison County,IA,16012,8101,7911,102.4,918,1176,1144,1080,712,1621,2074,2339,1163,1050,1573,800,362,40.7,3963,12049,5971,6078,98.2,15536,38,226,11919,5886,6033
19123,Mahaska County,IA,22164,11148,11016,101.2,1471,1569,1404,1496,1280,2653,2554,2654,1503,1575,2168,1202,635,39.3,5316,16848,8323,8525,97.6,21112,312,342,16703,8259,8444
19125,Marion County,IA,33172,16498,16674,98.9,1869,2114,2355,2567,2287,3684,3841,4193,2140,2317,3186,1737,882,39.4,7744,25428,12562,12866,97.6,31772,349,371,25202,12404,12798
19127,Marshall County,IA,39964,20308,19656,103.3,2659,2864,2939,2556,2449,4703,4475,4781,2928,2541,3780,2322,967,38.7,10064,29900,15034,14866,101.1,34303,502,1474,26526,13139,13387
19129,Mills County,IA,15034,7516,7518,100.0,818,1049,1075,972,793,1426,1810,2087,1157,1136,1670,675,366,42.5,3597,11437,5703,5734,99.5,14492,103,70,11333,5656,5677
19131,Mitchell County,IA,10608,5233,5375,97.4,607,734,678,689,636,1038,1079,1253,796,792,1071,798,437,43.6,2484,8124,3948,4176,94.5,10333,32,49,8060,3936,4124
19133,Monona County,IA,8730,4181,4549,91.9,451,445,573,472,438,932,978,974,666,676,1026,776,323,46.0,1786,6944,3297,3647,90.4,8428,27,0,6939,3294,3645
19135,Monroe County,IA,7807,3886,3921,99.1,438,464,606,493,435,799,893,1015,548,583,848,478,207,43.0,1840,5967,2957,3010,98.2,7591,2,8,5960,2954,3006
19137,Montgomery County,IA,10053,4850,5203,93.2,604,594,661,646,562,950,1095,1283,754,804,1097,715,288,44.2,2301,7752,3704,4048,91.5,9509,11,17,7631,3672,3959
19139,Muscatine County,IA,42889,21323,21566,98.9,2730,3155,2960,2839,2570,5413,5157,5404,2764,2989,4012,1886,1010,38.1,10700,32189,15963,16226,98.4,38753,1065,388,30807,15246,15561
19141,O'Brien County,IA,13835,6845,6990,97.9,865,947,923,814,708,1519,1579,1551,1025,1068,1325,873,638,41.9,3279,10556,5229,5327,98.2,13250,175,132,10414,5144,5270
19143,Osceola County,IA,6052,3059,2993,102.2,361,361,448,355,277,590,666,773,495,457,605,374,290,44.0,1416,4636,2287,2349,97.4,5717,76,8,4433,2162,2271
19145,Page County,IA,15268,7996,7272,110.0,783,785,866,878,821,1765,1931,1805,944,1385,1728,1045,532,44.1,3045,12223,6361,5862,108.5,14313,305,152,12030,6206,5824
19147,Palo Alto County,IA,9003,4468,4535,98.5,606,594,607,532,519,964,975,985,634,649,943,612,383,41.4,2130,6873,3367,3506,96.0,8625,214,30,6715,3275,3440
19149,Plymouth County,IA,25068,12296,12772,96.3,1549,1668,1869,1787,1375,2492,2981,3177,1846,1793,2411,1207,913,40.0,6258,18810,9108,9702,93.9,23694,244,163,18372,8857,9515
19151,Pocahontas County,IA,6797,3318,3479,95.4,361,432,402,298,427,635,676,821,603,598,771,525,248,47.6,1465,5332,2592,2740,94.6,6527,40,91,5173,2533,2640
19153,Polk County,IA,479612,236343,243269,97.2,34249,33477,33134,30322,30398,74600,65143,60610,30435,26022,36530,17301,7391,35.5,119828,359784,175159,184625,94.9,402987,32518,21909,337875,163579,174296
19155,Pottawattamie County,IA,93393,46036,47357,97.2,5677,6224,6371,6264,5659,11024,11239,11812,6630,6655,9098,4490,2250,39.7,21991,71402,34685,36717,94.5,86816,1638,728,69388,33639,35749
19157,Poweshiek County,IA,18388,8839,9549,92.6,899,977,1080,1801,1598,1869,1802,2113,1304,1230,1938,1243,534,40.5,3596,14792,7053,7739,91.1,17261,354,391,14433,6883,7550
19159,Ringgold County,IA,4964,2418,2546,95.0,296,337,342,322,221,504,488,549,341,372,583,367,242,44.0,1198,3766,1793,1973,90.9,4761,4,49,3718,1777,1941
19161,Sac County,IA,9802,4840,4962,97.5,580,575,664,584,458,941,972,1182,811,765,1109,805,356,46.1,2188,7614,3730,3884,96.0,9543,71,45,7522,3681,3841
19163,Scott County,IA,172446,84605,87841,96.3,11095,11775,11441,11034,10332,22793,21958,21908,11621,11297,15776,7739,3677,38.3,41147,131299,63789,67510,94.5,147646,12954,4698,127866,61978,65888
19165,Shelby County,IA,11606,5682,5924,95.9,585,822,668,742,553,1101,1183,1486,1073,761,1287,837,508,46.4,2587,9019,4342,4677,92.8,11247,88,22,8903,4252,4651
19167,Sioux County,IA,34827,17485,17342,100.8,2557,2500,2828,3079,3138,3915,4054,3315,2138,2002,2625,1827,849,33.4,9432,25395,12615,12780,98.7,32930,122,257,23948,11928,12020
19169,Story County,IA,96941,50622,46319,109.3,4450,4876,4217,10956,21630,12853,9264,8257,4689,4312,6359,3404,1674,26.6,16104,80837,42374,38463,110.2,83428,2213,7795,74285,38349,35936
19171,Tama County,IA,17032,8444,8588,98.3,1086,1043,1206,1201,876,1747,1785,2262,1268,1234,1741,1043,540,42.6,4096,12936,6375,6561,97.2,14952,157,78,12557,6172,6385
19173,Taylor County,IA,6167,3133,3034,103.3,342,435,433,369,323,656,668,694,427,465,724,404,227,42.3,1435,4732,2343,2389,98.1,5833,1,63,4570,2224,2346
19175,Union County,IA,12358,6001,6357,94.4,690,743,833,900,753,1385,1437,1435,934,773,1311,747,417,40.3,2775,9583,4617,4966,93.0,11949,62,180,9447,4531,4916
19177,Van Buren County,IA,7150,3665,3485,105.2,416,541,395,447,333,665,762,902,515,592,891,518,173,45.4,1669,5481,2755,2726,101.1,6960,48,37,5466,2744,2722
19179,Wapello County,IA,35141,17401,17740,98.1,2235,2090,2314,2302,2249,4323,4164,4373,2424,2567,3298,2014,788,39.6,7987,27154,13352,13802,96.7,30687,1248,432,25605,12545,13060
19181,Warren County,IA,50076,24497,25579,95.8,3004,3784,3411,3773,3203,5602,6450,6615,3441,3012,4536,2347,898,38.3,12423,37653,18132,19521,92.9,48092,260,348,37381,18030,19351
19183,Washington County,IA,22100,10964,11136,98.5,1491,1399,1582,1495,1271,2487,2491,2727,1528,1488,2210,1182,749,40.3,5466,16634,8122,8512,95.4,21043,172,132,16222,7873,8349
19185,Wayne County,IA,6429,3168,3261,97.1,461,446,447,395,317,696,618,675,533,446,677,514,204,43.2,1618,4811,2363,2448,96.5,6250,19,6,4776,2340,2436
19187,Webster County,IA,36545,18874,17671,106.8,2125,2324,1945,2747,2750,4485,4012,4210,2857,2503,3595,1943,1049,39.0,7768,28777,14906,13871,107.5,33123,1727,501,28184,14610,13574
19189,Winnebago County,IA,10534,5188,5346,97.0,565,714,537,839,762,1036,1084,1187,633,980,1114,763,320,41.8,2286,8248,4056,4192,96.8,9993,181,134,8167,4008,4159
19191,Winneshiek County,IA,20262,10058,10204,98.6,853,1001,1166,1875,2102,1855,1951,2345,1475,1582,2114,1288,655,41.5,3750,16512,8092,8420,96.1,19593,308,132,16260,7972,8288
19193,Woodbury County,IA,102586,50762,51824,98.0,7386,7119,7940,7388,6935,13462,12501,12184,6372,6228,8635,4425,2011,35.8,26845,75741,37143,38598,96.2,87959,3706,2908,72107,35204,36903
19195,Worth County,IA,7445,3755,3690,101.8,412,429,425,465,439,793,815,992,610,562,820,446,237,43.9,1561,5884,2962,2922,101.4,7184,121,25,5867,2958,2909
19197,Wright County,IA,12739,6434,6305,102.0,775,816,955,672,670,1320,1403,1358,863,1101,1369,872,565,43.5,3057,9682,4839,4843,99.9,11901,49,67,9264,4609,4655
20001,Allen County,KS,12556,6217,6339,98.1,722,816,798,909,751,1248,1423,1522,1046,780,1394,731,416,41.9,2835,9721,4698,5023,93.5,11683,125,94,9649,4644,5005
20003,Anderson County,KS,7835,3891,3944,98.7,478,545,629,510,448,731,867,894,578,498,858,631,168,40.8,2037,5798,2830,2968,95.4,7577,39,1,5769,2830,2939
20005,Atchison County,KS,16268,7844,8424,93.1,919,1012,1184,1384,1634,1777,1582,1828,1242,954,1514,786,452,36.6,3816,12452,5888,6564,89.7,14570,477,78,12375,5841,6534
20007,Barber County,KS,4624,2352,2272,103.5,313,439,211,228,217,570,377,554,393,324,564,308,126,43.6,1103,3521,1801,1720,104.7,4377,37,75,3452,1770,1682
20009,Barton County,KS,26453,13040,13413,97.2,1613,1888,1708,1764,1621,3261,2917,2734,2003,1958,2548,1654,784,39.9,6281,20172,9804,10368,94.6,24847,325,96,19197,9264,9933
20011,Bourbon County,KS,14608,7198,7410,97.1,1023,1167,930,1069,889,1614,1551,1567,1086,872,1537,840,463,39.1,3744,10864,5311,5553,95.6,13499,416,111,10848,5311,5537
20013,Brown County,KS,9626,4737,4889,96.9,621,647,768,567,475,1026,1027,1126,719,773,1057,525,295,42.1,2427,7199,3564,3635,98.0,8215,82,60,7152,3540,3612
20015,Butler County,KS,66698,33771,32927,102.6,3967,4514,5418,5095,3885,7686,8616,8612,4572,4435,5579,3084,1235,38.6,17130,49568,24928,24640,101.2,62026,1671,840,48732,24529,24203
20017,Chase County,KS,2637,1354,1283,105.5,121,153,236,149,158,220,294,303,194,172,350,202,85,44.8,603,2034,1015,1019,99.6,2499,44,3,2009,998,1011
20019,Chautauqua County,KS,3323,1747,1576,110.9,192,177,252,167,147,349,290,370,195,318,440,348,78,47.9,740,2583,1312,1271,103.2,2938,18,10,2572,1309,1263
20021,Cherokee County,KS,20179,10014,10165,98.5,1110,1535,1268,1355,1052,2216,2233,2665,1456,1450,2208,1136,495,41.3,4780,15399,7539,7860,95.9,18184,120,90,15283,7492,7791
20023,Cheyenne County,KS,2665,1326,1339,99.0,147,167,145,183,113,254,297,237,192,225,341,204,160,45.6,568,2097,1020,1077,94.7,2554,0,0,2016,981,1035
20025,Clark County,KS,2026,1050,976,107.6,157,154,120,95,87,189,207,248,150,141,196,227,55,45.3,501,1525,760,765,99.3,1917,10,23,1499,737,762
20027,Clay County,KS,8082,4036,4046,99.8,505,499,617,460,359,813,966,894,395,706,957,566,345,42.5,1942,6140,3042,3098,98.2,7800,72,48,6113,3042,3071
20029,Cloud County,KS,8938,4452,4486,99.2,611,628,519,486,693,987,903,1046,595,594,945,663,268,40.8,2109,6829,3352,3477,96.4,8513,175,8,6738,3324,3414
20031,Coffey County,KS,8254,4204,4050,103.8,435,430,559,505,492,903,883,1049,700,581,990,465,262,43.8,1778,6476,3263,3213,101.6,7893,66,8,6469,3259,3210
20033,Comanche County,KS,1740,926,814,113.8,67,102,132,111,80,84,223,192,135,160,273,117,64,48.1,386,1354,683,671,101.8,1725,4,0,1347,680,667
20035,Cowley County,KS,35351,17848,17503,102.0,2190,2392,2413,2589,2420,4112,4014,4276,2365,2181,3466,1880,1053,38.8,8406,26945,13426,13519,99.3,31109,1159,569,26402,13126,13276
20037,Crawford County,KS,38968,19495,19473,100.1,2331,2506,2314,3067,5489,4671,4131,4110,2183,2246,3303,1799,818,32.5,8526,30442,15043,15399,97.7,35547,884,724,29640,14638,15002
20039,Decatur County,KS,2860,1424,1436,99.2,162,163,129,108,151,304,300,274,188,296,360,278,147,50.6,543,2317,1152,1165,98.9,2798,15,11,2250,1122,1128
20041,Dickinson County,KS,18828,9488,9340,101.6,1144,1197,1324,1201,918,2129,2322,2222,1411,1297,1903,1316,444,41.3,4475,14353,7199,7154,100.6,17852,259,100,14167,7086,7081
20043,Doniphan County,KS,7684,3921,3763,104.2,376,510,322,881,592,769,813,885,506,581,796,404,249,41.0,1464,6220,3198,3022,105.8,7108,459,5,6178,3167,3011
20045,Douglas County,KS,120290,59669,60621,98.4,6093,6570,5902,11113,20884,17836,13984,11665,6140,5898,8557,3995,1653,29.8,22223,98067,48472,49595,97.7,99132,5254,6347,92577,45384,47193
20047,Edwards County,KS,2869,1430,1439,99.4,174,145,229,129,79,363,298,372,237,237,341,163,102,45.7,654,2215,1125,1090,103.2,2727,10,22,2044,1035,1009
20049,Elk County,KS,2523,1233,1290,95.6,126,82,237,128,66,204,220,284,227,219,384,267,79,52.3,545,1978,967,1011,95.6,2367,10,12,1970,965,1005
20051,Ellis County,KS,28775,14329,14446,99.2,1726,1851,1820,2095,3829,3895,3033,2826,1439,1946,2323,1472,520,32.5,6321,22454,11204,11250,99.6,26783,312,324,22032,11080,10952
20053,Ellsworth County,KS,6231,3536,2695,131.2,325,306,307,311,461,826,731,797,361,522,675,416,193,42.1,1147,5084,2917,2167,134.6,5647,199,80,4996,2843,2153
20055,Finney County,KS,36750,18897,17853,105.8,3270,3299,2917,3076,2667,5006,4314,4382,2052,1862,2410,910,585,30.8,11277,25473,13054,12419,105.1,29758,1067,1509,20802,10323,10479
20057,Ford County,KS,34179,17756,16423,108.1,3085,2920,2737,2686,2413,4786,4134,4129,2182,1489,1932,1148,538,32.2,10345,23834,12433,11401,109.1,30528,685,469,17697,9128,8569
20059,Franklin County,KS,25558,12546,13012,96.4,1534,1958,1588,1913,1452,2936,2936,3356,2097,1583,2528,1155,522,40.0,6170,19388,9461,9927,95.3,23867,237,98,19186,9331,9855
20061,Geary County,KS,34025,18172,15853,114.6,4104,3172,2114,1865,4494,7113,4015,2351,900,1130,1627,807,333,26.4,10508,23517,12643,10874,116.3,23076,6376,1006,22831,12421,10410
20063,Gove County,KS,2644,1330,1314,101.2,157,180,161,97,124,314,211,256,212,230,333,254,115,48.2,568,2076,1017,1059,96.0,2532,14,14,2046,1002,1044
20065,Graham County,KS,2519,1261,1258,100.2,119,157,155,133,56,253,272,260,278,168,300,231,137,50.4,514,2005,981,1024,95.8,2274,105,44,1978,971,1007
20067,Grant County,KS,7467,3888,3579,108.6,591,814,592,599,463,817,806,919,441,463,653,174,135,32.6,2327,5140,2636,2504,105.3,6597,3,32,4406,2246,2160
20069,Gray County,KS,6039,3031,3008,100.8,453,451,566,448,343,692,768,656,383,384,493,293,109,36.0,1773,4266,2126,2140,99.3,5847,53,7,3792,1873,1919
20071,Greeley County,KS,1185,596,589,101.2,77,82,97,79,40,125,127,114,99,102,106,79,58,42.2,309,876,435,441,98.6,1042,0,0,814,421,393
20073,Greenwood County,KS,6081,3065,3016,101.6,297,402,373,316,278,540,634,725,515,498,827,494,182,48.6,1300,4781,2391,2390,100.0,5782,13,11,4760,2383,2377
20075,Hamilton County,KS,2591,1413,1178,119.9,99,346,175,168,138,309,421,228,191,165,204,76,71,35.8,714,1877,1007,870,115.7,2356,138,0,1597,834,763
20077,Harper County,KS,5594,2846,2748,103.6,384,399,377,336,230,625,579,590,395,434,618,399,228,42.4,1379,4215,2086,2129,98.0,5356,10,22,4142,2043,2099
20079,Harvey County,KS,34503,17159,17344,98.9,2139,1927,2730,2740,2240,4005,3632,3970,2345,2160,3267,2134,1214,39.2,8463,26040,12753,13287,96.0,32126,574,218,25281,12323,12958
20081,Haskell County,KS,4018,2017,2001,100.8,272,260,407,367,230,395,568,412,241,296,371,173,26,36.9,1152,2866,1426,1440,99.0,3461,1,5,2428,1221,1207
20083,Hodgeman County,KS,1876,956,920,103.9,120,83,117,138,108,160,168,230,183,156,213,134,66,47.6,407,1469,749,720,104.0,1794,1,36,1399,701,698
20085,Jackson County,KS,13266,6627,6639,99.8,869,839,1009,885,734,1359,1472,1778,710,1113,1484,785,229,41.2,3316,9950,4922,5028,97.9,11453,28,72,9866,4872,4994
20087,Jefferson County,KS,18890,9560,9330,102.5,990,1220,1290,1270,874,1996,2102,2672,1567,1422,2022,1050,415,43.3,4347,14543,7300,7243,100.8,18097,137,3,14495,7289,7206
20089,Jewell County,KS,2885,1473,1412,104.3,149,164,148,165,59,297,248,298,232,270,424,313,118,52.8,555,2330,1186,1144,103.7,2781,10,5,2302,1161,1141
20091,Johnson County,KS,591506,290098,301408,96.2,37945,40317,42041,38208,33818,81292,82470,78486,38613,35147,49670,22018,11481,37.6,145592,445914,215808,230106,93.8,508409,27703,30087,420909,202607,218302
20093,Kearny County,KS,3907,1860,2047,90.9,312,342,284,356,307,385,387,497,230,235,319,217,36,34.7,1123,2784,1352,1432,94.4,3694,101,15,2457,1195,1262
20095,Kingman County,KS,7340,3671,3669,100.1,383,381,541,478,357,706,792,923,608,571,793,585,222,45.4,1640,5700,2794,2906,96.1,7093,34,2,5645,2766,2879
20097,Kiowa County,KS,2505,1216,1289,94.3,167,144,162,233,182,230,221,279,157,196,275,154,105,41.6,588,1917,942,975,96.6,2351,21,19,1859,900,959
20099,Labette County,KS,20119,9902,10217,96.9,1324,1244,1388,1256,1077,2389,2132,2611,1470,1511,2120,1074,523,41.0,4786,15333,7461,7872,94.8,17858,957,31,15293,7448,7845
20101,Lane County,KS,1564,798,766,104.2,103,109,92,128,65,164,215,200,108,92,137,98,53,40.7,387,1177,598,579,103.3,1514,0,19,1167,590,577
20103,Leavenworth County,KS,80745,43283,37462,115.5,5205,5292,5519,5065,5094,10627,11886,10346,5729,4588,6864,3447,1083,37.8,19203,61542,33215,28327,117.3,66592,7124,1170,60670,32802,27868
20105,Lincoln County,KS,3044,1561,1483,105.3,145,156,260,205,146,226,328,355,247,255,379,211,131,46.5,687,2357,1176,1181,99.6,2986,5,0,2348,1170,1178
20107,Linn County,KS,9671,4847,4824,100.5,535,537,708,602,449,870,1195,1199,803,636,1256,580,301,44.4,2196,7475,3721,3754,99.1,9258,80,50,7462,3709,3753
20109,Logan County,KS,2805,1408,1397,100.8,197,137,231,176,149,295,384,232,179,259,278,145,143,39.7,692,2113,1056,1057,99.9,2658,2,0,2074,1021,1053
20111,Lyon County,KS,33251,16107,17144,94.0,1962,2142,2132,2646,4466,3897,3516,3512,2132,1936,2710,1617,583,33.4,7447,25804,12347,13457,91.8,29661,763,710,23567,11147,12420
20113,McPherson County,KS,28567,14070,14497,97.1,1609,1722,1960,1998,1856,3290,3136,3259,2151,2013,2842,1418,1313,40.8,6515,22052,10842,11210,96.7,27274,331,193,21833,10655,11178
20115,Marion County,KS,11964,5994,5970,100.4,608,744,770,831,807,1082,1199,1374,1078,707,1401,906,457,44.5,2582,9382,4647,4735,98.1,11440,95,44,9332,4629,4703
20117,Marshall County,KS,9749,4887,4862,100.5,617,650,675,607,421,1004,1056,1067,844,727,1024,641,416,42.8,2340,7409,3695,3714,99.5,9430,30,38,7369,3667,3702
20119,Meade County,KS,4180,2090,2090,100.0,263,288,300,321,254,514,417,544,331,224,359,233,132,37.9,1051,3129,1548,1581,97.9,3541,26,30,2890,1434,1456
20121,Miami County,KS,33417,16658,16759,99.4,1903,2361,2498,2186,1769,3303,4173,4672,2641,2217,3280,1773,641,42.1,8235,25182,12492,12690,98.4,31914,498,191,24944,12325,12619
20123,Mitchell County,KS,6145,3125,3020,103.5,404,414,349,455,373,592,621,647,436,402,708,491,253,43.1,1373,4772,2425,2347,103.3,5963,44,17,4757,2416,2341
20125,Montgomery County,KS,32521,16205,16316,99.3,2046,2251,2193,2006,2081,3787,3429,3894,2289,2287,3409,1948,901,40.3,7720,24801,12112,12689,95.5,27395,1638,317,24450,11881,12569
20127,Morris County,KS,5566,2773,2793,99.3,317,290,395,306,217,551,578,644,417,496,690,420,245,46.6,1202,4364,2175,2189,99.4,5347,11,33,4297,2140,2157
20129,Morton County,KS,2754,1375,1379,99.7,132,251,170,260,79,369,231,332,189,163,317,178,83,40.5,700,2054,988,1066,92.7,2531,22,17,1883,885,998
20131,Nemaha County,KS,10121,5127,4994,102.7,745,758,707,706,582,1052,1046,1165,574,794,902,624,466,39.9,2688,7433,3701,3732,99.2,9801,73,12,7406,3686,3720
20133,Neosho County,KS,16108,7984,8124,98.3,1107,957,1245,1176,845,1773,1743,1902,1191,1074,1641,918,536,40.2,3988,12120,5982,6138,97.5,15280,208,11,11924,5862,6062
20135,Ness County,KS,2876,1472,1404,104.8,189,147,194,113,131,311,216,333,269,246,361,236,130,50.0,617,2259,1133,1126,100.6,2684,15,10,2157,1084,1073
20137,Norton County,KS,5446,3018,2428,124.3,338,223,312,294,287,826,582,719,307,441,558,251,308,42.7,1057,4389,2553,1836,139.1,5033,151,27,4288,2464,1824
20139,Osage County,KS,15881,7953,7928,100.3,883,1105,1020,1017,864,1541,1721,2039,1392,1194,1742,1008,355,43.8,3705,12176,6006,6170,97.3,15238,94,30,12149,5981,6168
20141,Osborne County,KS,3530,1765,1765,100.0,207,189,224,178,196,404,315,371,333,251,391,294,177,46.7,745,2785,1380,1405,98.2,3395,17,3,2778,1375,1403
20143,Ottawa County,KS,5822,2997,2825,106.1,300,317,426,409,286,531,713,753,510,420,631,370,156,43.0,1334,4488,2243,2245,99.9,5600,57,42,4464,2231,2233
20145,Pawnee County,KS,6629,3670,2959,124.0,321,381,199,440,332,881,808,887,341,695,686,587,71,43.0,1224,5405,3084,2321,132.9,5941,308,4,5370,3059,2311
20147,Phillips County,KS,5340,2631,2709,97.1,307,397,285,299,324,552,539,597,424,397,669,396,154,44.3,1198,4142,2041,2101,97.1,5163,40,29,4074,2003,2071
20149,Pottawatomie County,KS,23847,11934,11913,100.2,1862,2180,1834,1658,1232,3002,3173,2646,1639,1258,1966,942,455,35.4,7030,16817,8439,8378,100.7,22485,313,186,16464,8213,8251
20151,Pratt County,KS,9452,4724,4728,99.9,744,637,668,701,600,1046,910,970,655,736,886,686,213,38.5,2411,7041,3446,3595,95.9,8917,239,10,6918,3389,3529
20153,Rawlins County,KS,2502,1277,1225,104.2,140,148,144,89,135,245,264,276,218,171,340,248,84,48.8,513,1989,1007,982,102.5,2312,16,3,1929,962,967
20155,Reno County,KS,62765,31578,31187,101.3,3541,3904,4294,4252,3705,7570,7254,7428,4198,4499,6414,3951,1755,40.3,14250,48515,24284,24231,100.2,57332,1855,354,47442,23822,23620
20157,Republic County,KS,4658,2244,2414,93.0,242,262,298,216,226,404,425,531,355,422,615,426,236,50.7,970,3688,1755,1933,90.8,4539,53,11,3664,1742,1922
20159,Rice County,KS,9658,4853,4805,101.0,583,773,481,720,867,1053,948,1069,659,705,971,539,290,38.9,2211,7447,3759,3688,101.9,8786,189,79,7107,3553,3554
20161,Riley County,KS,75056,39748,35308,112.6,4212,3340,3046,7851,18860,13274,6880,5215,3060,2628,3847,1675,1168,25.1,12432,62624,33590,29034,115.7,61781,4680,3801,58783,31856,26927
20163,Rooks County,KS,5053,2428,2625,92.5,323,281,314,327,222,559,518,574,504,313,565,369,184,44.7,1117,3936,1914,2022,94.7,4860,89,4,3927,1906,2021
20165,Rush County,KS,3022,1503,1519,98.9,185,184,164,161,143,322,279,364,228,241,344,249,158,46.6,660,2362,1147,1215,94.4,2882,6,17,2359,1147,1212
20167,Russell County,KS,6948,3451,3497,98.7,399,443,381,431,253,695,710,958,495,546,833,582,222,49.1,1447,5501,2700,2801,96.4,6567,160,0,5373,2645,2728
20169,Saline County,KS,54701,27149,27552,98.5,3491,3395,3813,3413,3499,6876,6538,6715,3890,3659,5244,2907,1261,38.6,12841,41860,20626,21234,97.1,47992,1536,1233,40354,19846,20508
20171,Scott County,KS,4917,2555,2362,108.2,339,385,390,268,314,511,583,599,311,326,443,273,175,39.7,1314,3603,1794,1809,99.2,4634,0,61,3379,1669,1710
20173,Sedgwick County,KS,513375,253563,259812,97.6,36221,37317,37575,34300,35350,73496,62476,60024,33639,30923,42094,20725,9235,35.4,132927,380448,185961,194487,95.6,399953,45401,22290,358546,175275,183271
20175,Seward County,KS,22349,11410,10939,104.3,2016,2184,1826,1812,1588,3547,2609,2556,900,1212,1106,704,289,29.4,7073,15276,7831,7445,105.2,13284,1039,592,10959,5354,5605
20177,Shawnee County,KS,177852,85977,91875,93.6,11223,12346,11561,11477,10667,22188,20917,21617,12204,12352,17723,9442,4135,39.1,42326,135526,64487,71039,90.8,146615,15142,2664,131763,62700,69063
20179,Sheridan County,KS,2506,1286,1220,105.4,139,183,163,133,71,274,294,266,201,193,298,199,92,44.9,594,1912,968,944,102.5,2417,25,0,1871,937,934
20181,Sherman County,KS,5938,3086,2852,108.2,395,328,453,340,327,599,1006,492,436,448,593,342,179,39.3,1403,4535,2267,2268,100.0,5392,114,55,4394,2212,2182
20183,Smith County,KS,3627,1796,1831,98.1,188,166,230,197,145,318,352,417,290,333,474,326,191,51.4,709,2918,1444,1474,98.0,3499,12,27,2892,1440,1452
20185,Stafford County,KS,4181,2126,2055,103.5,261,218,313,269,234,450,373,522,342,318,418,324,139,44.1,971,3210,1598,1612,99.1,3962,12,4,3101,1527,1574
20187,Stanton County,KS,2052,1010,1042,96.9,151,166,204,163,93,244,234,225,86,135,147,156,48,35.3,614,1438,689,749,92.0,1993,0,0,1316,618,698
20189,Stevens County,KS,5603,2837,2766,102.6,419,453,524,331,355,708,662,618,391,326,442,261,113,35.1,1648,3955,2028,1927,105.2,4840,43,18,3149,1666,1483
20191,Sumner County,KS,23114,11557,11557,100.0,1394,1590,1727,1530,1257,2492,2588,2850,1802,1654,2280,1260,690,41.2,5683,17431,8590,8841,97.2,21726,237,150,17339,8559,8780
20193,Thomas County,KS,7810,3773,4037,93.5,563,485,461,702,584,993,824,852,504,566,667,458,151,36.0,1773,6037,2850,3187,89.4,7328,177,72,5757,2725,3032
20195,Trego County,KS,2840,1422,1418,100.3,104,100,172,162,169,264,310,344,192,305,352,195,171,49.4,503,2337,1177,1160,101.5,2753,3,48,2329,1177,1152
20197,Wabaunsee County,KS,6889,3490,3399,102.7,406,480,464,487,328,636,731,881,576,555,782,384,179,43.8,1640,5249,2615,2634,99.3,6537,37,88,5230,2610,2620
20199,Wallace County,KS,1574,768,806,95.3,103,132,110,82,77,169,169,173,104,106,180,93,76,41.8,409,1165,573,592,96.8,1480,3,6,1137,556,581
20201,Washington County,KS,5493,2807,2686,104.5,366,310,355,283,322,527,564,648,406,403,622,448,239,45.4,1232,4261,2154,2107,102.2,5389,9,8,4170,2096,2074
20203,Wichita County,KS,2130,999,1131,88.3,114,169,95,173,79,314,179,279,153,175,219,111,70,42.3,535,1595,767,828,92.6,1896,20,14,1388,677,711
20205,Wilson County,KS,8688,4261,4427,96.3,585,472,662,563,409,871,893,1037,607,763,1027,529,270,43.7,2085,6603,3210,3393,94.6,8222,40,1,6580,3188,3392
20207,Woodson County,KS,3157,1606,1551,103.5,186,195,190,178,100,326,349,344,235,283,434,219,118,47.4,686,2471,1253,1218,102.9,2930,14,0,2470,1252,1218
20209,Wyandotte County,KS,164861,81809,83052,98.5,13287,13206,12535,10880,10541,24773,21343,19006,9969,9481,11916,5648,2276,33.7,45940,118921,58201,60720,95.9,96974,36685,7557,99532,47408,52124
21001,Adair County,KY,19222,9540,9682,98.5,973,944,1114,1561,1431,2239,2113,2591,1336,1349,2161,1166,244,41.8,3749,15473,7531,7942,94.8,18239,603,120,15230,7387,7843
21003,Allen County,KY,20944,10456,10488,99.7,1352,1343,1469,1212,1151,2661,2402,2848,1585,1293,2216,977,435,40.7,4982,15962,7903,8059,98.1,20213,208,130,15756,7770,7986
21005,Anderson County,KY,22409,10976,11433,96.0,1434,1577,1371,1261,1397,2577,2865,3427,1452,1589,2144,1003,312,41.4,5348,17061,8171,8890,91.9,21341,627,61,16910,8128,8782
21007,Ballard County,KY,8032,3966,4066,97.5,421,417,606,516,448,790,935,1059,545,629,945,528,193,43.6,1765,6267,3067,3200,95.8,7452,328,19,6241,3057,3184
21009,Barren County,KY,43884,21118,22766,92.8,2814,2808,3025,2790,2575,5020,5269,6076,3161,2821,4298,2260,967,40.5,10480,33404,15764,17640,89.4,40712,1547,148,32784,15454,17330
21011,Bath County,KY,12355,6142,6213,98.9,830,807,1016,871,621,1308,1519,1676,942,768,1152,593,252,40.6,3205,9150,4469,4681,95.5,11921,188,58,9104,4462,4642
21013,Bell County,KY,26791,13174,13617,96.7,1603,1574,1572,1534,1586,3285,3153,3646,2117,1742,3040,1519,420,41.7,5699,21092,10215,10877,93.9,25531,742,45,21039,10175,10864
21015,Boone County,KY,130820,64953,65867,98.6,8689,9330,10543,8997,7520,16170,18250,18140,8577,7740,10619,4591,1654,37.5,34587,96233,47276,48957,96.6,118715,3815,3137,92333,45076,47257
21017,Bourbon County,KY,20058,9618,10440,92.1,1235,1285,1267,1165,1046,2456,2285,2871,1280,1368,2187,1305,308,41.8,4535,15523,7392,8131,90.9,18128,1401,162,14761,6998,7763
21019,Boyd County,KY,47682,23854,23828,100.1,2772,3107,2472,2825,2397,5669,6044,6538,3253,3591,5117,2677,1220,42.3,10160,37522,18613,18909,98.4,44852,1096,142,37284,18464,18820
21021,Boyle County,KY,29972,15008,14964,100.3,1506,1483,1932,2413,2612,3225,3444,3891,2008,1897,3080,1780,701,40.3,5982,23990,11840,12150,97.4,26229,2388,264,23520,11643,11877
21023,Bracken County,KY,8305,4184,4121,101.5,530,559,557,503,430,983,1028,1146,701,527,802,348,191,41.4,1989,6316,3151,3165,99.6,8047,30,91,6299,3134,3165
21025,Breathitt County,KY,12977,6515,6462,100.8,815,587,764,741,863,1552,1692,1863,994,969,1378,559,200,42.2,2642,10335,5128,5207,98.5,12602,171,43,10311,5104,5207
21027,Breckinridge County,KY,20176,10173,10003,101.7,1156,976,1636,1305,1053,2097,2306,2767,1302,1690,2445,1120,323,43.1,4625,15551,7732,7819,98.9,19266,358,71,15470,7662,7808
21029,Bullitt County,KY,80171,40070,40101,99.9,4084,4537,5624,5233,4796,10107,10668,11924,5327,5589,7790,3236,1256,40.4,17706,62465,30685,31780,96.6,76851,886,580,61915,30470,31445
21031,Butler County,KY,12764,6420,6344,101.2,744,802,815,784,630,1590,1612,1681,858,942,1373,647,286,41.3,2891,9873,4880,4993,97.7,12366,81,40,9661,4763,4898
21033,Caldwell County,KY,12702,6249,6453,96.8,695,889,796,726,639,1530,1346,1581,1044,803,1505,753,395,44.0,2835,9867,4683,5184,90.3,11813,796,0,9764,4580,5184
21035,Calloway County,KY,38837,18835,20002,94.2,1978,1968,1941,3602,5192,4435,4023,4564,2233,2365,3780,1975,781,35.6,7039,31798,15351,16447,93.3,35515,1369,426,30875,14804,16071
21037,Campbell County,KY,92861,45407,47454,95.7,5388,5608,5244,6461,6455,13195,11420,11942,6549,6482,8290,4146,1681,38.2,19677,73184,35452,37732,94.0,86974,2982,917,72257,35117,37140
21039,Carlisle County,KY,4784,2338,2446,95.6,314,252,353,272,238,546,565,624,263,370,531,330,126,42.8,1090,3694,1757,1937,90.7,4581,38,38,3688,1756,1932
21041,Carroll County,KY,10671,5466,5205,105.0,792,852,734,500,615,1419,1425,1309,884,531,966,438,206,38.5,2751,7920,4075,3845,106.0,9793,340,35,7711,3909,3802
21043,Carter County,KY,27159,13345,13814,96.6,1659,1415,1948,1800,1721,3095,3166,3654,1683,2052,2943,1495,528,41.6,6051,21108,10225,10883,94.0,26608,152,29,20984,10168,10816
21045,Casey County,KY,15885,7749,8136,95.2,940,1005,990,1002,942,1738,1913,2088,1013,1092,1889,962,311,42.6,3603,12282,5900,6382,92.4,15418,126,38,12145,5825,6320
21047,Christian County,KY,71414,37966,33448,113.5,6672,5463,4671,4678,9283,11726,7633,6413,3030,3234,4763,2819,1029,28.3,19328,52086,27989,24097,116.2,50879,15683,1167,51383,27741,23642
21049,Clark County,KY,35971,17561,18410,95.4,2239,2007,2411,2093,1939,4402,4398,5224,2515,2435,3735,1906,667,42.3,8066,27905,13257,14648,90.5,33297,1674,221,27547,13098,14449
21051,Clay County,KY,20368,10674,9694,110.1,1216,1255,1152,1078,1127,3013,2869,2930,1438,1285,1884,909,212,39.6,4340,16028,8456,7572,111.7,19055,799,0,15886,8343,7543
21053,Clinton County,KY,10193,5093,5100,99.9,665,550,692,693,464,1209,1153,1373,747,702,1133,584,228,41.9,2329,7864,3889,3975,97.8,9890,37,30,7793,3845,3948
21055,Crittenden County,KY,9000,4595,4405,104.3,487,471,704,496,475,973,1073,1170,641,689,1064,571,186,43.6,2022,6978,3503,3475,100.8,8724,71,0,6961,3496,3465
21057,Cumberland County,KY,6697,3253,3444,94.5,422,453,367,274,306,791,661,887,625,471,833,465,142,46.0,1477,5220,2528,2692,93.9,6216,140,51,5176,2519,2657
21059,Daviess County,KY,100474,49081,51393,95.5,6773,6565,7174,6307,5869,12730,12312,12520,6886,6559,9635,5106,2038,38.9,24495,75979,36487,39492,92.4,90657,4372,1767,74327,35604,38723
21061,Edmonson County,KY,12138,6117,6021,101.6,553,501,753,769,765,1346,1532,1669,938,865,1468,726,253,44.3,2260,9878,4977,4901,101.6,11588,181,10,9862,4977,4885
21063,Elliott County,KY,7510,4269,3241,131.7,350,390,396,342,501,1025,1124,959,571,427,828,482,115,41.4,1381,6129,3539,2590,136.6,7205,268,0,6122,3532,2590
21065,Estill County,KY,14224,7015,7209,97.3,786,920,824,797,785,1614,1725,2127,1097,903,1631,752,263,43.5,3076,11148,5456,5692,95.9,14096,16,2,11144,5454,5690
21067,Fayette County,KY,320601,157231,163370,96.2,19563,18946,18005,22135,33780,49638,42068,37990,19810,17127,24890,11878,4771,34.6,67051,253550,122957,130593,94.2,239996,46844,12028,234505,112371,122134
21069,Fleming County,KY,14513,7152,7361,97.2,1055,942,955,890,809,1618,1687,1993,1008,1019,1565,712,260,41.4,3553,10960,5378,5582,96.3,13961,318,13,10936,5360,5576
21071,Floyd County,KY,36456,17813,18643,95.5,2176,2089,2279,2193,2066,4307,4570,5021,2780,2597,3993,1879,506,42.2,7874,28582,13645,14937,91.4,35532,356,121,28506,13608,14898
21073,Franklin County,KY,50529,24519,26010,94.3,2898,2712,3190,3137,3052,6718,6133,6963,3698,3423,5261,2438,906,40.9,10570,39959,19095,20864,91.5,41652,4729,915,38697,18477,20220
21075,Fulton County,KY,6130,3077,3053,100.8,393,352,405,271,363,812,571,831,349,553,716,390,124,43.5,1342,4788,2343,2445,95.8,4410,1472,9,4773,2334,2439
21077,Gallatin County,KY,8737,4491,4246,105.8,570,555,625,610,535,1077,1063,1286,662,561,790,307,96,38.8,2154,6583,3290,3293,99.9,8121,176,6,6412,3207,3205
21079,Garrard County,KY,17445,8506,8939,95.2,989,1094,1157,975,840,1866,2134,2587,1459,1223,1846,974,301,43.0,3906,13539,6446,7093,90.9,16735,338,45,13388,6349,7039
21081,Grant County,KY,24951,12323,12628,97.6,1765,2217,1613,1734,1515,3228,2934,3451,1757,1333,2118,1038,248,36.3,6673,18278,9075,9203,98.6,23820,199,31,18267,9075,9192
21083,Graves County,KY,37248,18338,18910,97.0,2218,2426,2669,2612,2145,4339,4339,4757,2767,2187,3858,2186,745,39.7,8986,28262,13628,14634,93.1,33366,1662,169,27642,13235,14407
21085,Grayson County,KY,26247,13073,13174,99.2,1631,1645,1843,1744,1516,3071,3220,3353,1839,1862,2740,1367,416,40.3,6260,19987,9864,10123,97.4,25179,303,16,19820,9819,10001
21087,Green County,KY,10979,5381,5598,96.1,588,576,717,663,495,1234,1277,1522,773,923,1300,691,220,44.6,2317,8662,4222,4440,95.1,10447,285,9,8577,4176,4401
21089,Greenup County,KY,35555,17392,18163,95.8,1897,2155,2268,2012,1886,3833,4330,4877,2688,2396,4177,2316,720,43.4,7638,27917,13370,14547,91.9,34497,381,177,27809,13297,14512
21091,Hancock County,KY,8720,4523,4197,107.8,574,541,660,624,493,926,1005,1282,626,518,887,456,128,39.9,2201,6519,3304,3215,102.8,8380,137,50,6475,3286,3189
21093,Hardin County,KY,108527,54044,54483,99.2,7245,7211,7700,7212,7443,14750,13864,14407,7505,6338,8929,4345,1578,37.0,26688,81839,40406,41433,97.5,86124,12569,2364,80505,39926,40579
21095,Harlan County,KY,26699,12871,13828,93.1,1680,1903,1532,1489,1398,3325,3134,3562,1775,2123,2958,1372,448,41.3,6107,20592,9796,10796,90.7,25501,610,78,20525,9748,10777
21097,Harrison County,KY,18722,9241,9481,97.5,1139,1124,1172,1277,1066,2020,2203,2711,1374,1370,1933,1057,276,42.2,4312,14410,7041,7369,95.5,17824,322,0,14293,6943,7350
21099,Hart County,KY,18729,9211,9518,96.8,1349,1211,1277,1222,1069,2120,2055,2646,1414,1302,1791,955,318,40.5,4671,14058,6870,7188,95.6,17480,766,91,13963,6824,7139
21101,Henderson County,KY,45829,22133,23696,93.4,2736,2903,3123,2689,2408,5728,5762,5981,3414,3196,4701,2245,943,41.2,10487,35342,16856,18486,91.2,40333,3345,194,35036,16704,18332
21103,Henry County,KY,15911,7910,8001,98.9,943,967,1161,1057,889,1752,1904,2190,1136,1207,1686,749,270,41.4,3744,12167,5916,6251,94.6,14844,472,100,12025,5830,6195
21105,Hickman County,KY,4510,2137,2373,90.1,198,169,354,347,157,364,562,596,233,433,579,335,183,48.0,865,3645,1752,1893,92.6,3913,377,32,3640,1747,1893
21107,Hopkins County,KY,45331,22126,23205,95.4,2670,2950,3007,2712,2367,5509,5477,5940,3454,3088,4857,2717,583,41.8,10420,34911,16672,18239,91.4,40802,2916,269,34693,16551,18142
21109,Jackson County,KY,13369,6632,6737,98.4,814,761,904,799,712,1491,1790,1877,1129,818,1415,732,127,42.2,3010,10359,5062,5297,95.6,13111,42,0,10359,5062,5297
21111,Jefferson County,KY,767419,370951,396468,93.6,48537,46481,47668,46027,48348,113143,96048,96995,53349,50024,70638,34475,15686,38.3,170991,596428,283453,312975,90.6,549506,166794,22040,568336,268760,299576
21113,Jessamine County,KY,53032,25630,27402,93.5,3425,3670,3646,3772,3745,6623,6514,7034,3596,3220,4669,2365,753,37.8,12933,40099,19110,20989,91.0,48430,2445,766,38901,18389,20512
21115,Johnson County,KY,22634,11121,11513,96.6,1369,1457,1390,1339,1196,2620,2917,3152,1633,1554,2499,1095,413,41.8,5091,17543,8520,9023,94.4,22018,111,341,17419,8476,8943
21117,Kenton County,KY,165668,81938,83730,97.9,11090,12074,10164,9893,9918,24490,21714,21369,11490,10355,14122,6397,2592,37.1,39781,125887,61540,64347,95.6,149303,7640,2108,122773,59869,62904
21119,Knott County,KY,15260,7504,7756,96.8,817,809,892,1066,1113,1614,1775,2164,1158,1159,1670,824,199,43.2,3066,12194,5917,6277,94.3,14846,79,32,12152,5878,6274
21121,Knox County,KY,31365,15302,16063,95.3,2009,1986,2035,2227,2092,3859,3688,4155,1977,1970,3134,1748,485,40.0,7329,24036,11547,12489,92.5,30238,255,118,23766,11284,12482
21123,Larue County,KY,14204,7005,7199,97.3,764,930,904,925,736,1594,1917,1866,1130,1007,1381,838,212,40.9,3211,10993,5395,5598,96.4,13186,503,53,10748,5215,5533
21125,Laurel County,KY,60357,29539,30818,95.8,3682,3583,4093,3851,3504,7645,7778,8556,3871,4103,5873,3044,774,40.0,13957,46400,22390,24010,93.3,58536,444,237,46312,22336,23976
21127,Lawrence County,KY,15671,7768,7903,98.3,1043,1073,1022,886,829,1802,1952,2122,1192,1074,1671,748,257,41.2,3733,11938,5790,6148,94.2,15490,29,32,11899,5775,6124
21129,Lee County,KY,6881,3624,3257,111.3,369,365,405,522,258,831,838,1056,549,492,766,323,107,43.6,1406,5475,2825,2650,106.6,6612,52,15,5419,2803,2616
21131,Leslie County,KY,10283,5045,5238,96.3,577,494,777,525,565,1299,1232,1471,737,814,1061,578,153,42.3,2208,8075,3970,4105,96.7,10039,15,39,8063,3964,4099
21133,Letcher County,KY,22295,10850,11445,94.8,1290,943,1790,1263,1081,2612,2759,3040,1825,1564,2619,1275,234,42.4,4819,17476,8371,9105,91.9,21812,83,59,17415,8350,9065
21135,Lewis County,KY,13417,6717,6700,100.3,803,750,941,693,788,1517,1637,1861,1094,935,1435,720,243,42.8,2995,10422,5176,5246,98.7,13117,90,19,10403,5176,5227
21137,Lincoln County,KY,24476,11984,12492,95.9,1625,1809,1374,1446,1272,2927,2904,3447,1770,1536,2549,1472,345,41.3,5790,18686,9051,9635,93.9,23154,466,40,18486,8927,9559
21139,Livingston County,KY,9235,4581,4654,98.4,517,489,577,492,434,954,1057,1280,792,701,1174,595,173,46.0,1926,7309,3558,3751,94.9,8980,42,13,7309,3558,3751
21141,Logan County,KY,26902,13127,13775,95.3,1724,1570,1953,1721,1513,3186,3178,3435,1984,1743,2756,1675,464,40.7,6359,20543,9879,10664,92.6,24400,1806,69,20378,9742,10636
21143,Lyon County,KY,8271,4359,3912,111.4,273,376,295,300,464,862,946,1133,609,804,1357,686,166,50.6,1151,7120,3818,3302,115.6,7580,474,31,7040,3755,3285
21145,McCracken County,KY,65268,31322,33946,92.3,4049,3544,4411,3672,3651,7617,7971,8365,4551,4786,7138,3765,1748,42.2,14451,50817,23856,26961,88.5,55515,6843,573,50451,23720,26731
21147,McCreary County,KY,17465,9525,7940,120.0,1085,1017,1170,1066,1012,2397,2372,2479,1137,1058,1701,846,125,39.4,3955,13510,7449,6061,122.9,15732,989,79,13448,7400,6048
21149,McLean County,KY,9283,4580,4703,97.4,513,617,649,564,484,984,1070,1293,643,681,1050,565,170,42.4,2203,7080,3421,3659,93.5,8990,116,21,7046,3405,3641
21151,Madison County,KY,90802,44220,46582,94.9,5146,5464,5203,8262,11092,11224,11031,10809,5287,5153,7444,3266,1421,34.1,18955,71847,34505,37342,92.4,82952,3728,808,70480,33770,36710
21153,Magoffin County,KY,12491,6238,6253,99.8,777,676,905,749,648,1440,1543,1806,763,1091,1262,543,288,42.3,2856,9635,4756,4879,97.5,12470,4,13,9635,4756,4879
21155,Marion County,KY,19244,9759,9485,102.9,1148,1290,1441,1262,1216,2144,2305,2612,1478,1174,1918,924,332,39.3,4685,14559,7271,7288,99.8,17349,1408,41,14400,7128,7272
21157,Marshall County,KY,31192,15218,15974,95.3,1737,1896,1640,1696,1545,3347,3765,4144,2468,2192,3858,2142,762,44.9,6404,24788,11958,12830,93.2,30380,293,62,24693,11935,12758
21159,Martin County,KY,11648,6433,5215,123.4,558,614,730,605,671,1911,1648,1575,671,838,1129,512,186,39.5,2323,9325,5224,4101,127.4,10837,636,11,9302,5201,4101
21161,Mason County,KY,17112,8490,8622,98.5,1024,1226,991,1001,1112,2039,1959,2329,1355,1087,1783,787,419,40.6,3876,13236,6414,6822,94.0,15505,1082,155,12928,6145,6783
21163,Meade County,KY,28182,14232,13950,102.0,1507,2202,1533,1906,1732,3796,3721,3936,2128,1784,2431,1285,221,38.6,6458,21724,10867,10857,100.1,25861,1061,185,21546,10808,10738
21165,Menifee County,KY,6443,3414,3029,112.7,363,307,423,373,278,839,672,901,498,487,757,500,45,44.6,1348,5095,2625,2470,106.3,6331,10,20,5075,2625,2450
21167,Mercer County,KY,21592,10617,10975,96.7,1260,1414,1274,1193,1355,2355,2413,3120,1603,1620,2351,1232,402,43.2,4776,16816,8073,8743,92.3,20078,909,98,16520,7966,8554
21169,Metcalfe County,KY,10036,4999,5037,99.2,641,504,778,531,550,1088,1112,1387,875,686,1104,668,112,43.9,2306,7730,3782,3948,95.8,9608,156,40,7695,3758,3937
21171,Monroe County,KY,10627,5332,5295,100.7,678,563,764,613,593,1166,1291,1448,907,648,1138,605,213,41.4,2397,8230,4045,4185,96.7,10166,265,31,8055,3947,4108
21173,Montgomery County,KY,27884,13737,14147,97.1,1851,1928,1789,1667,1611,3507,3610,4028,1887,1610,2708,1321,367,39.7,6675,21209,10186,11023,92.4,26342,780,21,21051,10112,10939
21175,Morgan County,KY,13288,7481,5807,128.8,636,569,754,731,753,1976,1855,1882,1044,902,1332,667,187,42.0,2476,10812,6129,4683,130.9,12461,452,78,10732,6074,4658
21177,Muhlenberg County,KY,30951,15239,15712,97.0,1651,1326,2139,2182,1913,3819,3698,4230,2275,1955,3312,1952,499,42.4,6306,24645,12071,12574,96.0,28689,1404,243,24331,11908,12423
21179,Nelson County,KY,45650,22785,22865,99.7,2868,3062,2988,3010,2742,5567,5700,6417,3124,3197,4388,1740,847,39.8,10893,34757,16968,17789,95.4,41726,2341,247,34472,16753,17719
21181,Nicholas County,KY,7153,3439,3714,92.6,468,484,465,431,446,776,861,1000,571,445,721,373,112,41.1,1699,5454,2652,2802,94.6,6872,114,0,5425,2652,2773
21183,Ohio County,KY,24071,11843,12228,96.9,1405,1757,1841,1432,1265,2831,2919,3138,1483,1754,2503,1354,389,40.3,5961,18110,8969,9141,98.1,23253,208,67,17802,8773,9029
21185,Oldham County,KY,65967,34554,31413,110.0,3365,4405,5669,5201,3708,6713,9854,10449,4468,3751,5486,2226,672,38.9,16871,49096,26095,23001,113.5,60313,2437,1028,48155,25563,22592
21187,Owen County,KY,10796,5368,5428,98.9,550,959,469,603,641,1167,1343,1482,867,784,1199,530,202,42.8,2433,8363,4151,4212,98.6,10668,62,0,8359,4147,4212
21189,Owsley County,KY,4442,2018,2424,83.3,355,192,212,219,375,426,527,574,296,422,495,254,95,43.4,898,3544,1616,1928,83.8,4150,243,7,3544,1616,1928
21191,Pendleton County,KY,14572,7422,7150,103.8,890,957,926,911,822,1704,1703,2209,1196,992,1415,599,248,40.6,3399,11173,5613,5560,101.0,14130,157,83,11135,5596,5539
21193,Perry County,KY,26624,13179,13445,98.0,1680,1298,2007,1531,1361,3234,3383,3812,2095,1874,2663,1336,350,41.2,5942,20682,10023,10659,94.0,25529,495,229,20463,9879,10584
21195,Pike County,KY,59497,28874,30623,94.3,3264,3247,3537,3716,3479,6799,7512,8252,4872,4058,6582,3224,955,42.5,12314,47183,22576,24607,91.7,58027,530,331,47017,22552,24465
21197,Powell County,KY,12304,6033,6271,96.2,804,831,847,754,689,1587,1580,1677,828,801,1213,538,155,38.6,2966,9338,4572,4766,95.9,11920,44,74,9250,4512,4738
21199,Pulaski County,KY,64350,31316,33034,94.8,3819,3795,4255,3748,3577,7570,7590,9017,4476,4498,7144,3463,1398,42.0,14338,50012,24081,25931,92.9,61976,572,529,49334,23690,25644
21201,Robertson County,KY,2123,981,1142,85.9,151,166,128,99,72,234,234,310,174,99,266,142,48,42.9,507,1616,810,806,100.5,2085,38,0,1616,810,806
21203,Rockcastle County,KY,16820,8155,8665,94.1,936,1081,1006,1009,912,1948,1992,2515,1259,1168,1786,858,350,42.7,3710,13110,6331,6779,93.4,16489,26,23,13105,6326,6779
21205,Rowan County,KY,24507,11806,12701,93.0,1335,1185,1342,2904,3486,2962,2551,2761,1316,1326,1958,1072,309,30.6,4630,19877,9463,10414,90.9,23515,375,196,19602,9273,10329
21207,Russell County,KY,17778,8648,9130,94.7,1047,1220,1002,1063,881,2007,1995,2526,1262,1264,2062,1121,328,43.3,4021,13757,6596,7161,92.1,16823,54,142,13501,6453,7048
21209,Scott County,KY,54667,26941,27726,97.2,3594,4031,3973,3860,3609,7264,8072,7456,3746,2582,4213,1608,659,36.2,13869,40798,19937,20861,95.6,48003,2528,650,39556,19220,20336
21211,Shelby County,KY,47325,22962,24363,94.2,3131,2874,3104,3148,2683,6010,6109,6835,3078,3111,4566,1960,716,39.4,11047,36278,17212,19066,90.3,41165,3244,439,34416,16134,18282
21213,Simpson County,KY,18183,8952,9231,97.0,1172,1399,1112,1140,1080,2263,2155,2375,1120,1381,1845,895,246,39.0,4447,13736,6631,7105,93.3,15583,1867,121,13616,6559,7057
21215,Spencer County,KY,18680,9449,9231,102.4,1029,1128,1291,1266,978,1952,2562,3090,1741,1126,1624,713,180,42.1,4295,14385,7245,7140,101.5,17966,347,63,14313,7173,7140
21217,Taylor County,KY,25571,12527,13044,96.0,1625,1586,1585,2069,2021,3192,2588,3051,1981,1421,2508,1356,588,37.6,5773,19798,9516,10282,92.6,23349,1095,273,19478,9272,10206
21219,Todd County,KY,12316,6087,6229,97.7,849,887,1008,777,649,1583,1458,1540,809,835,1092,645,184,37.8,3289,9027,4476,4551,98.4,10771,1012,8,8782,4307,4475
21221,Trigg County,KY,14449,7196,7253,99.2,871,889,823,1025,528,1348,1611,1912,927,1307,1940,987,281,46.2,3186,11263,5474,5789,94.6,13062,1076,68,11204,5436,5768
21223,Trimble County,KY,8558,4221,4337,97.3,447,347,718,617,418,917,1066,1262,737,564,925,387,153,43.4,1870,6688,3257,3431,94.9,8247,14,0,6613,3222,3391
21225,Union County,KY,14638,7644,6994,109.3,798,798,693,1085,1739,1683,1646,1799,988,1039,1491,636,243,38.1,2804,11834,6153,5681,108.3,12178,1950,68,11701,6046,5655
21227,Warren County,KY,128652,62979,65673,95.9,8274,7479,8695,11997,14180,17238,15653,14718,7574,6561,9794,5030,1459,32.8,29223,99429,48264,51165,94.3,104990,11459,5151,92909,44546,48363
21229,Washington County,KY,12023,5900,6123,96.4,726,797,858,736,711,1335,1426,1648,907,728,1247,690,214,40.7,2802,9221,4478,4743,94.4,10828,644,106,9028,4339,4689
21231,Wayne County,KY,20546,10227,10319,99.1,1196,1083,1292,1160,1112,2361,2557,2706,1463,1492,2399,1331,394,42.5,4315,16231,8043,8188,98.2,19378,407,32,15882,7724,8158
21233,Webster County,KY,13068,6479,6589,98.3,784,902,841,745,752,1565,1589,1715,875,1031,1324,727,218,41.0,3028,10040,5017,5023,99.9,11891,474,7,9705,4805,4900
21235,Whitley County,KY,36131,17701,18430,96.0,2717,2349,2560,2724,2705,4312,4125,4505,2267,2165,3379,1676,647,36.6,9061,27070,13068,14002,93.3,35062,319,87,26849,12965,13884
21237,Wolfe County,KY,7207,3603,3604,100.0,455,399,515,409,255,852,935,951,537,523,833,411,132,41.8,1668,5539,2661,2878,92.5,7097,4,5,5534,2661,2873
21239,Woodford County,KY,26318,12448,13870,89.7,1471,1714,1521,1821,1489,2698,3239,3606,1890,2199,2938,1232,500,42.5,5857,20461,9527,10934,87.1,24118,1196,107,19453,8939,10514
22001,Acadia Parish,LA,62457,30442,32015,95.1,4373,4696,4557,4172,3454,8434,7511,7901,4373,3706,5489,2734,1057,36.7,16352,46105,22054,24051,91.7,49556,10841,55,45617,21765,23852
22003,Allen Parish,LA,25618,14542,11076,131.3,1625,1547,1611,1420,1520,3749,3682,3707,1600,1382,2347,1093,335,38.2,5736,19882,11514,8368,137.6,18941,4845,152,18915,10636,8279
22005,Ascension Parish,LA,123114,60828,62286,97.7,8738,9956,8886,8764,6997,17058,17694,16735,7352,6924,8847,3852,1311,35.7,33232,89882,43633,46249,94.3,88833,26779,1297,87397,42217,45180
22007,Assumption Parish,LA,22478,10866,11612,93.6,1219,1109,1752,1441,1471,2707,2540,3067,1813,1457,2383,1094,425,40.9,4951,17527,8409,9118,92.2,15158,6819,17,17367,8305,9062
22009,Avoyelles Parish,LA,40669,20490,20179,101.5,2713,2064,3193,2470,2472,5584,5080,5010,2784,2502,3888,2234,675,38.2,9607,31062,15525,15537,99.9,26967,10942,214,30924,15478,15446
22011,Beauregard Parish,LA,37043,18833,18210,103.4,2485,1991,3061,2484,2338,4954,4685,4640,2475,2230,3413,1640,647,37.4,9183,27860,14092,13768,102.4,30920,4620,180,27509,13961,13548
22013,Bienville Parish,LA,13564,6397,7167,89.3,832,727,972,717,860,1582,1457,1726,1010,927,1455,989,310,41.9,3072,10492,4959,5533,89.6,7428,5858,5,10464,4943,5521
22015,Bossier Parish,LA,126499,62397,64102,97.3,8781,8998,8634,8000,8542,19454,16739,14798,7929,7148,10038,5537,1901,35.3,31521,94978,46409,48569,95.6,90919,28793,2395,92946,45584,47362
22017,Caddo Parish,LA,245831,116446,129385,90.0,16802,15596,16848,15190,15492,34358,29565,28824,16143,16412,23410,11879,5312,37.7,58834,186997,86775,100222,86.6,113489,120925,3166,184137,85379,98758
22019,Calcasieu Parish,LA,201619,98398,103221,95.3,14344,14464,13413,12674,13294,29768,24591,23902,14105,11682,17283,8967,3132,36.1,50316,151303,72778,78525,92.7,141058,50148,2842,148341,71316,77025
22021,Caldwell Parish,LA,9992,5239,4753,110.2,623,787,574,514,746,1284,1089,1318,663,582,1110,547,155,39.8,2330,7662,3955,3707,106.7,8163,1638,31,7589,3918,3671
22023,Cameron Parish,LA,6930,3355,3575,93.8,408,271,549,567,326,517,885,1095,583,621,639,329,140,44.1,1569,5361,2587,2774,93.3,6432,235,36,5168,2528,2640
22025,Catahoula Parish,LA,9766,5132,4634,110.7,574,596,605,509,821,1309,1329,996,638,750,918,562,159,38.1,2127,7639,4093,3546,115.4,6513,3159,16,7613,4080,3533
22027,Claiborne Parish,LA,15985,9131,6854,133.2,797,906,698,774,852,2373,2288,2125,1130,1028,1700,969,345,42.0,2892,13093,7626,5467,139.5,7279,8314,22,12995,7586,5409
22029,Concordia Parish,LA,19778,10049,9729,103.3,1244,1331,1328,1103,1489,2663,2333,2265,1444,1238,1935,1100,305,37.7,4709,15069,7662,7407,103.4,11433,8133,29,14826,7429,7397
22031,De Soto Parish,LA,27289,13298,13991,95.0,1765,1976,1815,1666,1553,3334,3363,3397,2107,1614,2776,1470,453,39.3,6694,20595,9765,10830,90.2,16770,9663,27,20510,9709,10801
22033,East Baton Rouge Parish,LA,443763,212317,231446,91.7,29247,27759,27641,31581,46954,64989,52534,49335,27344,25477,37071,17173,6658,34.0,101265,342498,160967,181531,88.7,207835,204562,14125,328863,153134,175729
22035,East Carroll Parish,LA,7096,4309,2787,154.6,474,346,368,246,777,1438,791,820,495,345,565,362,69,33.9,1270,5826,3664,2162,169.5,2084,4945,0,5812,3660,2152
22037,East Feliciana Parish,LA,19371,10783,8588,125.6,927,934,1015,1102,1129,2669,2338,2775,1708,1471,2051,1021,231,42.9,3522,15849,8835,7014,126.0,10556,8441,66,15758,8786,6972
22039,Evangeline Parish,LA,33589,17218,16371,105.2,2274,2408,2271,2571,2210,4642,3803,4226,1899,2216,2944,1728,397,35.7,8369,25220,12938,12282,105.3,22794,9273,158,24186,12052,12134
22041,Franklin Parish,LA,20238,9891,10347,95.6,1401,1601,1310,1258,1139,2541,2475,2229,1303,1408,1990,1314,269,38.4,5156,15082,7208,7874,91.5,13233,6862,0,15029,7202,7827
22043,Grant Parish,LA,22340,12624,9716,129.9,1260,1348,1225,1256,1252,3767,3279,2991,1521,1159,1989,1054,239,38.1,4621,17719,10256,7463,137.4,17554,3618,26,17174,9745,7429
22045,Iberia Parish,LA,71887,35150,36737,95.7,5221,5159,5382,4957,4403,9383,8302,9053,4688,4939,6102,3100,1198,36.5,18878,53009,25682,27327,94.0,43640,22780,1967,51528,24871,26657
22047,Iberville Parish,LA,32822,16535,16287,101.5,1833,1763,2153,1799,2239,5007,4163,4482,2377,2033,2939,1553,481,38.4,6935,25887,12953,12934,100.1,16282,15833,14,25777,12902,12875
22049,Jackson Parish,LA,15879,8052,7827,102.9,883,916,1095,801,952,2005,1946,1958,1130,1005,1779,1118,291,40.9,3393,12486,6316,6170,102.4,10770,4719,92,12325,6240,6085
22051,Jefferson Parish,LA,434850,210690,224160,94.0,28222,26372,26010,23654,25068,63359,54040,55476,30909,29407,42672,21069,8592,39.4,95900,338950,161783,177167,91.3,271300,117314,18260,309890,145798,164092
22053,Jefferson Davis Parish,LA,31441,15550,15891,97.9,2226,2029,2346,2183,1875,3922,3731,3793,1881,2390,2828,1525,712,37.8,7990,23451,11304,12147,93.1,25176,5178,154,23363,11304,12059
22055,Lafayette Parish,LA,241973,117992,123981,95.2,16669,16422,15164,15334,16464,40188,31835,29143,15048,14974,18538,8631,3563,35.2,57503,184470,88776,95694,92.8,167836,62785,4529,178447,85285,93162
22057,Lafourche Parish,LA,98108,48217,49891,96.6,6309,6225,6736,6455,5814,13929,11839,13236,6505,6303,8617,4561,1579,37.8,22921,75187,36555,38632,94.6,77504,13371,575,73466,35560,37906
22059,LaSalle Parish,LA,14936,7783,7153,108.8,879,861,1078,1046,1067,1933,1902,1867,751,1058,1493,761,240,38.8,3510,11426,6011,5415,111.0,12570,1695,179,11161,5772,5389
22061,Lincoln Parish,LA,47246,22972,24274,94.6,2709,2481,2673,4736,8823,5965,4608,4359,2395,2168,3543,2017,769,28.3,9509,37737,18158,19579,92.7,25624,19307,789,36417,17297,19120
22063,Livingston Parish,LA,138928,68224,70704,96.5,9222,9922,10730,9612,7653,19779,19703,18247,7678,8441,11401,4939,1601,36.6,35938,102990,50074,52916,94.6,125510,8305,867,101499,49322,52177
22065,Madison Parish,LA,11306,5630,5676,99.2,821,741,728,800,697,1841,1472,1286,626,727,919,472,176,35.2,2707,8599,4273,4326,98.8,3995,7202,0,8588,4272,4316
22067,Morehouse Parish,LA,25610,12309,13301,92.5,1731,2029,1440,1667,1674,2855,2892,3084,1885,1687,2717,1490,459,39.9,6231,19379,9122,10257,88.9,12664,12583,129,19326,9094,10232
22069,Natchitoches Parish,LA,38769,18562,20207,91.9,2487,2439,2822,3407,4616,4364,3848,4149,2123,2290,3586,1929,709,33.7,9272,29497,13732,15765,87.1,20665,15996,285,29309,13597,15712
22071,Orleans Parish,LA,390845,185513,205332,90.3,23112,22531,20691,21638,25389,70855,52231,47390,26028,25699,34088,14650,6543,36.8,78505,312340,145786,166554,87.5,132643,232660,11361,301828,140033,161795
22073,Ouachita Parish,LA,155494,74589,80905,92.2,10808,11492,10055,11124,10919,21980,19264,18460,9373,9533,12986,6908,2592,35.7,39035,116459,54719,61740,88.6,91884,58219,1558,115126,53982,61144
22075,Plaquemines Parish,LA,23338,11744,11594,101.3,1587,1618,1916,1594,1295,3106,2900,3453,1381,1446,1836,873,333,36.5,6097,17241,8482,8759,96.8,15858,4733,901,16784,8174,8610
22077,Pointe Coupee Parish,LA,22016,10574,11442,92.4,1305,1402,1340,1266,1323,2475,2389,2714,1563,1795,2629,1282,533,43.1,4907,17109,8117,8992,90.3,13636,7873,56,16972,8011,8961
22079,Rapides Parish,LA,130970,63380,67590,93.8,8893,8924,9147,8735,8359,17216,15694,16260,8941,7997,11996,6451,2357,37.4,32640,98330,46574,51756,90.0,83120,41341,1721,96729,45804,50925
22081,Red River Parish,LA,8565,4023,4542,88.6,546,661,589,551,428,973,907,1075,732,498,916,440,249,39.4,2105,6460,3037,3423,88.7,4945,3350,0,6451,3028,3423
22083,Richland Parish,LA,20350,9909,10441,94.9,1252,1377,1281,1376,1272,2515,2538,2487,1540,1218,2036,1004,454,38.8,4810,15540,7396,8144,90.8,12604,7339,78,15519,7394,8125
22085,Sabine Parish,LA,23991,11853,12138,97.7,1459,1673,1558,1609,1133,2858,2651,3005,1539,1681,2918,1485,422,41.1,5691,18300,8929,9371,95.3,16626,3834,86,18105,8837,9268
22087,St. Bernard Parish,LA,46266,22625,23641,95.7,3407,3638,3563,2819,2561,7826,6265,5389,3189,2496,3280,1433,400,34.2,12410,33856,16357,17499,93.5,32097,10757,1170,32669,15694,16975
22089,St. Charles Parish,LA,52773,26406,26367,100.1,3254,3735,3614,3493,3472,6640,6800,7493,4037,3355,4300,1880,700,37.9,13001,39772,19319,20453,94.5,36542,14059,528,39149,18911,20238
22091,St. Helena Parish,LA,10297,4977,5320,93.6,555,672,599,705,353,1610,1431,975,578,878,1281,410,250,39.4,2197,8100,3858,4242,90.9,4709,5409,26,7962,3784,4178
22093,St. James Parish,LA,21308,10111,11197,90.3,1268,1317,1396,1352,1342,2797,2428,2793,1443,1614,2060,1172,326,39.2,4890,16418,7745,8673,89.3,10366,10565,35,16252,7694,8558
22095,St. John the Baptist Parish,LA,43242,21197,22045,96.2,2841,3136,2872,2822,2853,5850,5202,5781,3092,2857,3789,1536,611,36.8,10720,32522,15763,16759,94.1,16501,24433,482,31751,15193,16558
22097,St. Landry Parish,LA,83172,40138,43034,93.3,6147,5813,6698,5650,5060,10538,9203,10112,5403,5441,7640,3963,1504,36.7,22320,60852,28635,32217,88.9,46586,34551,60,60372,28311,32061
22099,St. Martin Parish,LA,53732,26437,27295,96.9,3693,3658,3542,3353,3557,7334,6458,6943,3822,3461,4824,2110,977,37.7,13063,40669,19835,20834,95.2,35874,15629,536,40076,19440,20636
22101,St. Mary Parish,LA,50968,25211,25757,97.9,3512,3061,3723,3261,2901,6565,6055,6728,3521,3448,4764,2483,946,39.0,12343,38625,18801,19824,94.8,30016,15531,734,37480,18069,19411
22103,St. Tammany Parish,LA,255155,123830,131325,94.3,15313,15816,19170,16965,13559,29297,32536,34655,18156,17865,25995,11638,4190,40.2,61452,193703,92728,100975,91.8,211276,30925,4135,188820,89853,98967
22105,Tangipahoa Parish,LA,132057,63939,68118,93.9,9507,8647,9208,9418,9378,19127,16446,15326,8520,7989,11620,5485,1386,35.3,32437,99620,47521,52099,91.2,88627,38910,989,98074,46659,51415
22107,Tensas Parish,LA,4561,2247,2314,97.1,301,232,363,274,220,369,589,415,372,342,632,332,120,43.4,1085,3476,1640,1836,89.3,1979,2525,5,3464,1628,1836
22109,Terrebonne Parish,LA,112054,55354,56700,97.6,7908,7527,8596,6886,7027,16380,13879,14040,7530,6754,9303,4573,1651,35.8,28612,83442,40729,42713,95.4,78715,21311,1111,81080,39344,41736
22111,Union Parish,LA,22353,11150,11203,99.5,1285,1369,1379,1706,928,2555,2439,2735,1597,1836,2668,1388,468,42.1,4934,17419,8580,8839,97.1,15986,5533,33,17114,8392,8722
22113,Vermilion Parish,LA,59865,28936,30929,93.6,4067,4217,4352,4059,3275,7702,7551,7657,4333,3644,4961,2799,1248,38.0,15349,44516,21201,23315,90.9,48737,8693,1189,43658,20787,22871
22115,Vernon Parish,LA,49646,26265,23381,112.3,4136,3617,2965,3208,5548,8803,6077,4948,2171,2350,3555,1739,529,30.4,12452,37194,19968,17226,115.9,37633,7294,1045,36573,19857,16716
22117,Washington Parish,LA,46435,22925,23510,97.5,3017,3343,2805,3066,2684,5528,5897,5500,3079,3381,5003,2563,569,39.4,11181,35254,17164,18090,94.9,31086,14032,52,34931,17044,17887
22119,Webster Parish,LA,39242,19171,20071,95.5,2368,2235,2762,2349,2316,4794,4392,5078,2482,2899,4177,2500,890,41.4,8877,30365,14568,15797,92.2,24993,13346,106,30221,14523,15698
22121,West Baton Rouge Parish,LA,26101,12738,13363,95.3,1769,1950,1488,1647,1600,3917,3520,3283,1662,1786,2095,1161,223,36.3,6241,19860,9777,10083,97.0,15222,10458,16,19651,9586,10065
22123,West Carroll Parish,LA,11041,5593,5448,102.7,601,708,818,673,551,1421,1359,1340,850,652,1126,697,245,40.3,2523,8518,4228,4290,98.6,8842,1778,0,8473,4207,4266
22125,West Feliciana Parish,LA,15428,9875,5553,177.8,635,669,747,973,848,2486,2254,2444,1253,949,1370,689,111,41.4,2516,12912,8475,4437,191.0,8250,6861,94,12699,8386,4313
22127,Winn Parish,LA,14313,7625,6688,114.0,771,697,937,820,906,1992,1867,1777,990,940,1498,806,312,41.1,2942,11371,6200,5171,119.9,9471,4533,0,11269,6111,5158
23001,Androscoggin County,ME,107602,52573,55029,95.5,6399,6658,6562,6739,6518,13046,12897,14870,8098,7212,10878,5472,2253,41.0,23449,84153,40669,43484,93.5,98386,2562,839,82793,40027,42766
23003,Aroostook County,ME,67809,33546,34263,97.9,3356,3268,3517,3820,3568,6716,7064,9370,5621,5628,8985,4589,2307,48.0,12483,55326,27048,28278,95.7,64373,682,318,54385,26615,27770
23005,Cumberland County,ME,292307,141794,150513,94.2,14040,15837,15200,17521,18108,39350,35796,41411,22995,19916,30737,14317,7079,42.2,55077,237230,113626,123604,91.9,268151,8863,6350,230966,110449,120517
23007,Franklin County,ME,29982,14700,15282,96.2,1398,1428,1569,2034,1964,3284,2954,3886,2536,2492,3880,1671,886,46.3,5416,24566,11932,12634,94.4,28920,73,113,24410,11898,12512
23009,Hancock County,ME,54601,26374,28227,93.4,2424,2731,2637,2649,2588,6001,5677,7424,4376,4965,8025,3523,1581,48.8,9433,45168,21687,23481,92.4,52344,469,624,44264,21319,22945
23011,Kennebec County,ME,121753,59400,62353,95.3,5913,5972,7439,7393,7161,14031,13987,16990,9972,9250,13802,6735,3108,44.4,23609,98144,47288,50856,93.0,116530,1039,1108,96853,46576,50277
23013,Knox County,ME,39759,19815,19944,99.4,1758,1951,2157,1959,1920,4045,4469,5229,3030,3594,5673,2739,1235,48.4,7181,32578,15998,16580,96.5,38200,205,201,32204,15842,16362
23015,Lincoln County,ME,34201,16761,17440,96.1,1366,1831,1452,1631,1600,3330,3430,4450,2552,3296,5474,2695,1094,51.0,5721,28480,13718,14762,92.9,33143,129,340,28172,13562,14610
23017,Oxford County,ME,57550,28448,29102,97.8,2548,2928,3185,3329,2728,5946,6545,8036,4925,5151,7232,3462,1535,47.0,10773,46777,22820,23957,95.3,55391,212,217,46425,22692,23733
23019,Penobscot County,ME,151774,75235,76539,98.3,7090,7491,7959,10676,10670,20162,17044,20512,11689,11132,15949,8200,3200,42.0,27786,123988,60859,63129,96.4,143465,1291,1492,122087,60008,62079
23021,Piscataquis County,ME,16836,8408,8428,99.8,720,781,776,970,701,1418,1718,2302,1509,1582,2664,1128,567,51.5,2910,13926,6951,6975,99.7,16128,96,131,13753,6858,6895
23023,Sagadahoc County,ME,35452,17339,18113,95.7,1794,1985,1730,1835,1561,4011,3944,5044,3131,2689,4657,2117,954,46.9,6745,28707,13905,14802,93.9,33941,278,271,28122,13607,14515
23025,Somerset County,ME,50520,25021,25499,98.1,2353,3065,2480,2807,2439,5386,5774,7510,4310,3951,6361,2993,1091,46.4,9737,40783,20110,20673,97.3,48759,313,194,40429,19954,20475
23027,Waldo County,ME,39539,19409,20130,96.4,1795,2026,2242,2286,1970,4228,4596,5230,3198,3355,5475,2253,885,46.2,7418,32121,15539,16582,93.7,38044,234,182,31746,15404,16342
23029,Washington County,ME,31491,15468,16023,96.5,1495,1548,1873,1828,1640,2940,3240,4081,2582,2782,4487,2195,800,48.1,5993,25498,12440,13058,95.3,28604,244,149,24961,12286,12675
23031,York County,ME,204316,99651,104665,95.2,9586,9957,11996,11659,10837,24301,23350,29123,16680,16202,24002,11155,5468,45.2,38767,165549,79524,86025,92.4,195143,1778,2580,163100,78447,84653
24001,Allegany County,MD,71445,37335,34110,109.5,3213,3376,3589,5384,5962,8737,8128,9341,5033,4513,7700,4533,1936,41.7,12449,58996,30751,28245,108.9,62992,5796,670,58294,30357,27937
24003,Anne Arundel County,MD,571275,282621,288654,97.9,35179,35010,36532,34027,36943,80951,75265,79862,40568,34657,49616,23747,8918,38.3,127729,443546,217725,225821,96.4,415470,95710,21605,424382,208914,215468
24005,Baltimore County,MD,828018,392496,435522,90.1,48989,50347,49361,52616,51405,114114,100820,107871,56691,56548,77330,41174,20752,39.4,178924,649094,301304,347790,86.6,501423,239308,49885,606610,280136,326474
24009,Calvert County,MD,91511,45538,45973,99.1,4836,5286,6916,6535,5392,10206,10962,14598,7434,6094,7975,3796,1481,40.7,21322,70189,34534,35655,96.9,74326,10709,1718,69416,34182,35234
24011,Caroline County,MD,33049,16170,16879,95.8,2009,2240,2246,2175,1822,4124,4063,4323,2786,1962,3114,1541,644,39.7,7841,25208,12229,12979,94.2,26405,4666,229,24205,11737,12468
24013,Carroll County,MD,167699,82963,84736,97.9,8927,10011,10516,11588,10050,18884,19014,26313,13205,11757,16183,7574,3677,42.4,36679,131020,64136,66884,95.9,153534,5924,3176,128694,62922,65772
24015,Cecil County,MD,102552,51022,51530,99.0,5738,6654,6634,6656,5915,12637,12413,15196,7712,7358,9786,4358,1495,40.8,23332,79220,38876,40344,96.4,90069,6974,1446,77656,38150,39506
24017,Charles County,MD,159428,76779,82649,92.9,9567,10488,11237,11140,10192,20406,20602,25665,11079,9640,12067,5506,1839,38.4,38473,120955,57241,63714,89.8,70090,73300,5115,117552,55813,61739
24019,Dorchester County,MD,32138,15177,16961,89.5,1817,1678,2143,1758,1684,3858,3263,4241,2648,2311,3882,2186,669,44.6,6809,25329,11728,13601,86.2,21065,8549,354,24612,11406,13206
24021,Frederick County,MD,251422,123912,127510,97.2,14795,15589,17626,17242,15260,31512,32521,37744,18547,15118,20991,9888,4589,39.1,58744,192678,93903,98775,95.1,202622,24411,11192,181219,88513,92706
24023,Garrett County,MD,29235,14478,14757,98.1,1423,1601,1399,1742,1598,3167,3234,3982,2326,2327,3729,1986,721,46.2,5501,23734,11630,12104,96.1,28327,250,125,23632,11595,12037
24025,Harford County,MD,252222,123549,128673,96.0,14131,15504,16384,16263,15109,31283,30910,36859,18831,17100,23957,11382,4509,40.9,56568,195654,94325,101329,93.1,198359,34843,6571,192018,92660,99358
24027,Howard County,MD,318855,155961,162894,95.7,18938,21746,22810,21758,18303,38792,44836,47421,22679,18817,26373,11710,4672,38.8,77947,240908,115989,124919,92.9,181711,60232,57613,217313,104847,112466
24029,Kent County,MD,19536,9294,10242,90.7,779,923,843,1560,1498,1940,1661,2256,1537,1419,2821,1561,738,48.1,3082,16454,7751,8703,89.1,15774,2787,228,15811,7424,8387
24031,Montgomery County,MD,1043530,504128,539402,93.5,66017,67762,68222,63987,59642,133553,143550,147385,72637,63950,89196,46628,21001,39.2,243582,799948,379739,420209,90.4,553846,192639,154340,662718,312581,350137
24033,Prince George's County,MD,908670,437440,471230,92.8,59912,57057,54136,58834,62457,133571,122178,127338,61958,54407,73503,32004,11315,37.1,203037,705633,334014,371619,89.9,150782,569478,37453,599122,277059,322063
24035,Queen Anne's County,MD,49632,24634,24998,98.5,2513,2914,3356,3046,2697,5136,5501,7597,4225,3528,5521,2669,929,44.4,10767,38865,19115,19750,96.8,44328,3302,504,37865,18616,19249
24037,St. Mary's County,MD,112290,56147,56143,100.0,7146,6811,8688,7796,7522,15453,14301,16065,7581,6836,8382,4250,1459,36.7,27345,84945,42314,42631,99.3,87625,16431,2865,82517,41185,41332
24039,Somerset County,MD,25729,13926,11803,118.0,1244,1311,1186,1910,3053,3720,2781,3004,1639,1707,2432,1286,456,36.2,4455,21274,11650,9624,121.1,13569,10910,253,20831,11420,9411
24041,Talbot County,MD,37167,17627,19540,90.2,1661,1938,1974,2124,1531,3447,3418,4742,2625,3112,5622,3451,1522,50.5,6857,30310,14130,16180,87.3,30818,3887,503,29107,13437,15670
24043,Washington County,MD,150109,76330,73779,103.5,8659,9070,9290,9092,8919,19668,18443,21598,10164,9967,14129,7961,3149,40.5,32945,117164,59523,57641,103.3,123236,15984,2755,113910,57720,56190
24045,Wicomico County,MD,102539,48681,53858,90.4,6185,6058,6373,9179,10188,12142,11229,12219,7026,6093,9260,4945,1642,36.1,22505,80034,37277,42757,87.2,68178,26594,3215,75468,34946,40522
24047,Worcester County,MD,51765,25357,26408,96.0,2131,2322,2913,2509,2504,5092,5143,6767,3759,4486,7927,4687,1525,50.4,8966,42799,20658,22141,93.3,42965,6659,618,41648,20108,21540
24510,Baltimore city,MD,609032,286048,322984,88.6,39059,34991,33004,35406,42934,115551,75369,72925,38945,38127,48941,23464,10316,35.4,125823,483209,222261,260948,85.2,185489,379751,15693,456346,207798,248548
25001,Barnstable County,MA,213496,102086,111410,91.6,7845,8306,10014,10731,10745,18858,19014,26845,17566,19991,35915,18667,8999,53.3,32577,180919,85481,95438,89.6,195669,6210,3182,173791,81737,92054
25003,Berkshire County,MA,126425,61150,65275,93.7,5351,5708,6327,7963,8448,13214,13175,16999,10309,10311,16142,8539,3939,47.1,21646,104779,50105,54674,91.6,114485,3548,2248,101921,48788,53133
25005,Bristol County,MA,561037,271591,289446,93.8,29617,31500,34277,35745,37083,71640,68464,81493,40582,37338,53141,26262,13895,41.0,116601,444436,212194,232242,91.4,471827,23969,12741,421506,200309,221197
25007,Dukes County,MA,17312,8535,8777,97.2,636,792,1184,1223,653,1751,1967,2259,1236,1578,2582,1059,392,47.1,3207,14105,6930,7175,96.6,15247,813,59,13311,6555,6756
25009,Essex County,MA,783676,377772,405904,93.1,44158,43682,49700,51703,51471,96105,93719,110988,59359,51904,74910,35953,20024,40.9,168095,615581,291623,323958,90.0,626140,33424,26899,562172,264535,297637
25011,Franklin County,MA,70577,34374,36203,94.9,3062,3119,3889,3603,3758,8195,8346,9466,5950,6269,9384,3824,1712,46.7,12363,58214,28028,30186,92.9,65480,1066,908,56724,27278,29446
25013,Hampden County,MA,467871,225964,241907,93.4,26054,27688,29271,33043,34365,61717,53852,61222,33010,30636,43720,21923,11370,39.0,101742,366129,173782,192347,90.3,381040,41471,11197,352363,167020,185343
25015,Hampshire County,MA,161032,75294,85738,87.8,5535,6030,7494,18603,23237,17397,15769,18810,10756,10648,16307,7010,3436,36.5,23911,137121,62999,74122,85.0,141084,4186,8483,129958,59671,70287
25017,Middlesex County,MA,1600842,783073,817769,95.8,86429,87111,89648,102559,111770,246588,210197,220267,109401,96957,135467,69922,34526,38.5,319479,1281363,620176,661187,93.8,1227271,85583,190905,1124415,540715,583700
25019,Nantucket County,MA,11168,5720,5448,105.0,704,530,736,621,385,1698,1689,1698,718,758,984,437,210,40.3,2311,8857,4579,4278,107.0,9748,871,71,8052,4032,4020
25021,Norfolk County,MA,700437,336802,363635,92.6,37503,40230,42806,45395,43075,89333,87995,101191,50510,46431,64048,34507,17413,40.9,148128,552309,261184,291125,89.7,543394,49756,77446,505651,238127,267524
25023,Plymouth County,MA,515303,250326,264977,94.5,27334,29959,33099,34401,31385,55876,59406,77114,39816,36183,54024,26118,10588,42.7,111925,403378,193011,210367,91.7,427046,51537,7192,386564,185213,201351
25025,Suffolk County,MA,796605,384878,411727,93.5,42291,34499,35365,54354,76813,185420,102604,89295,43469,38783,53514,27381,12817,32.8,133635,662970,317192,345778,91.7,439961,178557,70597,547909,257406,290503
25027,Worcester County,MA,824772,406642,418130,97.3,44497,46735,51847,56914,56262,105693,100170,120455,61700,54471,73059,35614,17355,40.2,175640,649132,316556,332576,95.2,690146,41366,40508,608196,296290,311906
26001,Alcona County,MI,10353,5235,5118,102.3,316,376,386,403,358,702,771,1250,958,1122,2061,1245,405,58.2,1343,9010,4542,4468,101.7,10028,41,20,8968,4513,4455
26003,Alger County,MI,9151,5075,4076,124.5,329,419,380,491,540,1009,949,1130,754,893,1344,585,328,49.5,1386,7765,4365,3400,128.4,7773,702,13,7721,4343,3378
26005,Allegan County,MI,116143,58027,58116,99.8,7195,7803,8239,7566,6587,13799,13775,15767,9174,7596,11407,5422,1813,39.8,28289,87854,43549,44305,98.3,108625,1569,802,85934,42513,43421
26007,Alpena County,MI,28520,14068,14452,97.3,1362,1293,1671,1636,1403,2971,3048,3736,2587,2325,3578,1878,1032,48.1,5344,23176,11365,11811,96.2,27603,165,176,23025,11306,11719
26009,Antrim County,MI,23206,11582,11624,99.6,1003,1146,1202,1309,1090,2019,2139,3001,1877,2231,3628,1937,624,51.3,4242,18964,9360,9604,97.5,22292,103,82,18820,9287,9533
26011,Arenac County,MI,15070,7635,7435,102.7,682,743,770,810,675,1480,1513,1927,1302,1506,2194,1154,314,50.0,2721,12349,6239,6110,102.1,14500,62,55,12297,6231,6066
26013,Baraga County,MI,8421,4657,3764,123.7,350,429,428,424,548,1032,955,1140,696,592,1070,584,173,45.5,1508,6913,3883,3030,128.2,6181,783,34,6858,3840,3018
26015,Barry County,MI,60540,30464,30076,101.3,3357,3666,3941,3864,3355,6683,7002,8304,4626,4825,6546,2929,1442,42.5,13471,47069,23538,23531,100.0,58329,415,364,46594,23319,23275
26017,Bay County,MI,104104,51139,52965,96.6,5125,5917,6260,6040,6120,12528,11882,13735,7824,8262,11596,6397,2418,43.4,21278,82826,40205,42621,94.3,98568,1796,606,82251,39935,42316
26019,Benzie County,MI,17615,8750,8865,98.7,836,799,1003,912,778,1677,1740,2254,1434,1637,2652,1382,511,50.2,3250,14365,7043,7322,96.2,16863,32,76,14274,6997,7277
26021,Berrien County,MI,154133,75425,78708,95.8,8957,9826,9103,9541,9077,17956,17533,19878,11675,10843,16864,8501,4379,42.1,33829,120304,58159,62145,93.6,121313,22561,2931,115795,55767,60028
26023,Branch County,MI,43513,22481,21032,106.9,2607,2844,2855,2618,2275,5301,5006,5623,3518,2966,4652,2509,739,41.2,10038,33475,17418,16057,108.5,40858,1032,342,32411,16961,15450
26025,Calhoun County,MI,134212,65779,68433,96.1,8303,8241,8896,8953,8682,16266,15654,17336,9237,9414,13335,6992,2903,39.8,30883,103329,49787,53542,93.0,109110,14148,3233,100435,48352,52083
26027,Cass County,MI,51523,25836,25687,100.6,2575,2901,3263,3227,2782,5212,5645,7309,3919,4235,6536,3058,861,45.2,10760,40763,20276,20487,99.0,45779,2666,431,40359,20042,20317
26029,Charlevoix County,MI,26188,12974,13214,98.2,1154,1417,1509,1509,1323,2567,2543,3438,2167,2357,3666,1896,642,48.6,5058,21130,10461,10669,98.1,24951,122,129,20927,10368,10559
26031,Cheboygan County,MI,25418,12713,12705,100.1,1018,994,1383,1365,1172,2369,2471,3365,2107,2372,4039,2057,706,51.1,4257,21161,10503,10658,98.5,23683,205,111,21034,10447,10587
26033,Chippewa County,MI,37629,20498,17131,119.7,1832,1798,2032,2356,3584,4769,4525,4944,2731,2407,3819,2014,818,40.5,6881,30748,16984,13764,123.4,26615,2265,372,30178,16653,13525
26035,Clare County,MI,30651,15242,15409,98.9,1677,1893,1430,1662,1532,3224,3068,3918,2618,2508,4244,2166,711,47.2,6077,24574,12184,12390,98.3,29488,190,36,24457,12124,12333
26037,Clinton County,MI,78389,38704,39685,97.5,4366,4835,5180,5160,4965,9154,9540,11127,6000,5165,7727,3756,1414,40.6,17679,60710,29750,30960,96.1,73354,1442,1183,59564,29162,30402
26039,Crawford County,MI,13892,7065,6827,103.5,649,733,643,756,642,1293,1256,1899,1348,1212,2013,1177,271,50.8,2511,11381,5769,5612,102.8,13337,103,129,11281,5747,5534
26041,Delta County,MI,36026,17924,18102,99.0,1809,1931,2105,2069,1644,3680,3829,4532,2808,3202,4772,2634,1011,47.4,7201,28825,14168,14657,96.7,33746,121,156,28685,14129,14556
26043,Dickinson County,MI,25439,12759,12680,100.6,1261,1428,1387,1465,1308,2653,2742,3314,2112,2178,3043,1824,724,46.7,5049,20390,10179,10211,99.7,24356,158,166,20253,10115,10138
26045,Eaton County,MI,109456,53603,55853,96.0,6004,6258,6511,6938,6980,13825,12988,14251,7826,8275,11922,5613,2065,40.9,23052,86404,41883,44521,94.1,94564,7435,2552,84380,40799,43581
26047,Emmet County,MI,33104,16359,16745,97.7,1603,1522,2021,2057,1810,3648,3678,4199,2827,2547,4308,2075,809,45.5,6457,26647,12976,13671,94.9,30573,246,205,26401,12879,13522
26049,Genesee County,MI,407875,196695,211180,93.1,24184,25262,26643,26412,25962,49070,48045,54842,29577,28541,40017,20959,8361,40.5,92788,315087,149254,165833,90.0,304896,81062,4211,311809,147509,164300
26051,Gladwin County,MI,25279,12744,12535,101.7,1332,1346,1256,1392,1108,2288,2391,3240,1988,2283,3889,2186,580,50.1,4845,20434,10205,10229,99.8,24513,78,131,20387,10193,10194
26053,Gogebic County,MI,15061,8019,7042,113.9,559,768,615,714,870,1612,1637,1906,1335,1193,2167,1014,671,49.3,2353,12708,6775,5933,114.2,13708,582,82,12646,6740,5906
26055,Grand Traverse County,MI,92181,45476,46705,97.4,4800,5368,5273,5273,4879,11961,10585,12204,7250,6898,10542,4264,2884,42.8,18763,73418,35798,37620,95.2,87402,835,537,72254,35070,37184
26057,Gratiot County,MI,40916,21928,18988,115.5,1987,2496,2131,2921,3141,5347,5177,5376,2811,2492,3844,2132,1061,39.5,8152,32764,17706,15058,117.6,37227,2346,183,32581,17618,14963
26059,Hillsdale County,MI,45757,22841,22916,99.7,2737,2519,2952,3254,3035,4800,4924,5818,3569,3430,5106,2644,969,42.3,10045,35712,17703,18009,98.3,44217,332,180,35453,17587,17866
26061,Houghton County,MI,36070,19495,16575,117.6,1884,2096,2050,3505,5366,3850,3397,3541,2070,2188,3482,1761,880,33.0,7285,28785,15719,13066,120.3,33634,278,1000,27709,15067,12642
26063,Huron County,MI,31349,15550,15799,98.4,1535,1672,1751,1738,1575,2932,2997,4047,2536,2817,4263,2396,1090,49.2,6064,25285,12495,12790,97.7,30404,150,199,25115,12420,12695
26065,Ingham County,MI,290587,141572,149015,95.0,16265,15524,16189,26304,40006,41094,32209,31527,17108,16250,23253,10020,4838,32.0,57893,232694,112051,120643,92.9,216025,33930,19624,217370,103817,113553
26067,Ionia County,MI,64300,34266,30034,114.1,3669,3843,4692,4197,4218,8242,8525,8886,4369,4336,5768,2461,1094,38.7,14833,49467,26662,22805,116.9,58958,2976,269,49041,26379,22662
26069,Iosco County,MI,25197,12546,12651,99.2,1127,1201,1076,1192,1060,2298,2336,3048,2219,2317,4181,2391,751,52.9,4156,21041,10454,10587,98.7,24088,184,190,20734,10306,10428
26071,Iron County,MI,11152,5543,5609,98.8,421,568,470,517,466,886,994,1329,1045,1112,1814,1011,519,54.3,1788,9364,4653,4711,98.8,10681,61,65,9311,4651,4660
26073,Isabella County,MI,70688,34337,36351,94.5,3298,3333,3550,8327,13410,8690,6758,7148,3711,3857,5039,2465,1102,28.1,12272,58416,28155,30261,93.0,62196,1916,1262,57106,27467,29639
26075,Jackson County,MI,158636,80972,77664,104.3,9058,9309,9866,10031,10196,19753,18587,21585,11896,11076,16016,7861,3402,41.2,34414,124222,63313,60909,103.9,138511,12350,1310,122762,62563,60199
26077,Kalamazoo County,MI,262745,128538,134207,95.8,15864,15434,16179,18660,31966,35278,30435,29498,15059,16017,22277,11265,4813,34.4,57063,205682,99425,106257,93.6,212216,29215,6259,198517,95994,102523
26079,Kalkaska County,MI,17585,8943,8642,103.5,891,977,1175,972,854,2010,2037,2360,1362,1471,2166,998,312,44.4,3685,13900,7047,6853,102.8,16871,170,95,13740,6944,6796
26081,Kent County,MI,648121,319318,328803,97.1,43911,44048,43670,43358,45197,101438,80668,79886,41650,38391,49864,24555,11485,35.3,158213,489908,238281,251627,94.7,515653,62188,19427,460441,222376,238065
26083,Keweenaw County,MI,2111,1089,1022,106.6,75,106,66,77,84,158,197,210,196,201,459,227,55,57.5,312,1799,942,857,109.9,2048,19,4,1777,923,854
26085,Lake County,MI,11852,6053,5799,104.4,513,543,541,549,555,990,1097,1477,1213,1086,2031,980,277,53.2,1949,9903,5043,4860,103.8,10301,940,25,9794,4999,4795
26087,Lapeer County,MI,88038,44834,43204,103.8,4311,5001,5323,5783,5128,9266,9970,13449,7324,6994,9574,4544,1371,44.1,18413,69625,35325,34300,103.0,84158,1108,500,68478,34613,33865
26089,Leelanau County,MI,21652,10727,10925,98.2,880,958,1014,1023,1050,1856,1933,2415,1894,2127,3792,1965,745,54.1,3536,18116,8874,9242,96.0,20123,105,137,17856,8732,9124
26091,Lenawee County,MI,98381,49699,48682,102.1,5276,5365,6317,6606,6418,11266,11713,13156,7141,7073,10847,5126,2077,41.9,20856,77525,38900,38625,100.7,91576,2471,305,76232,38132,38100
26093,Livingston County,MI,189754,95184,94570,100.6,9631,10812,12291,13038,11031,20080,21919,29624,15551,14405,19476,8978,2918,43.5,41196,148558,73969,74589,99.2,182813,1135,1760,146864,73253,73611
26095,Luce County,MI,6338,3756,2582,145.5,264,314,277,351,349,784,851,861,429,504,738,418,198,44.7,1046,5292,3184,2108,151.0,5043,429,32,5228,3144,2084
26097,Mackinac County,MI,10780,5494,5286,103.9,389,447,493,495,575,983,1032,1385,930,1103,1707,980,261,52.8,1690,9090,4630,4460,103.8,8023,363,74,8840,4522,4318
26099,Macomb County,MI,870325,423761,446564,94.9,47739,50580,52412,52458,53640,114772,105675,124763,65192,58704,82316,42719,19355,40.9,184922,685403,329060,356343,92.3,704624,101734,34996,654955,314222,340733
26101,Manistee County,MI,24457,12695,11762,107.9,930,1044,1415,1381,1341,2463,2401,3116,2062,2194,3582,1787,741,49.3,4272,20185,10537,9648,109.2,22297,710,92,19986,10442,9544
26103,Marquette County,MI,66686,33610,33076,101.6,3188,3517,3295,4673,7550,7901,7131,7643,4559,4940,7223,3546,1520,39.1,12017,54669,27485,27184,101.1,62152,1118,627,54196,27318,26878
26105,Mason County,MI,28954,14333,14621,98.0,1498,1604,1734,1694,1431,3030,3027,3481,2265,2509,3894,2237,550,46.2,5930,23024,11336,11688,97.0,27438,261,167,22770,11171,11599
26107,Mecosta County,MI,43251,21810,21441,101.7,2078,2045,2424,4334,5444,4552,3999,4764,2925,2864,4665,2363,794,36.9,8057,35194,17672,17522,100.9,40183,1296,370,34848,17488,17360
26109,Menominee County,MI,23074,11700,11374,102.9,1010,1159,1187,1389,1144,2174,2446,3074,2064,1971,3060,1701,695,48.8,4258,18816,9470,9346,101.3,21756,73,94,18721,9466,9255
26111,Midland County,MI,83355,41012,42343,96.9,4595,5086,5015,5337,4948,10257,9816,11481,6304,5525,8160,4512,2319,41.8,17945,65410,31794,33616,94.6,77659,1167,1916,63647,30890,32757
26113,Missaukee County,MI,15028,7648,7380,103.6,989,950,950,890,810,1590,1573,1921,1138,1160,1811,1033,213,43.5,3480,11548,5846,5702,102.5,14463,95,29,11430,5760,5670
26115,Monroe County,MI,149727,73880,75847,97.4,7840,8339,9951,9649,8749,17065,17563,21240,12120,11007,15509,7680,3015,42.6,32354,117373,57426,59947,95.8,141090,3568,864,116196,56772,59424
26117,Montcalm County,MI,63413,32593,30820,105.8,3584,4105,4035,3815,3760,7747,7564,8790,4830,4360,6327,3328,1168,40.7,14244,49169,25368,23801,106.6,60014,1387,224,48797,25200,23597
26119,Montmorency County,MI,9265,4673,4592,101.8,318,336,464,411,347,684,773,1112,863,1050,1711,918,278,56.1,1381,7884,3970,3914,101.4,8951,22,14,7862,3953,3909
26121,Muskegon County,MI,173297,86161,87136,98.9,10615,11053,11569,11087,10611,22486,20720,21943,12705,11967,16852,8239,3450,39.3,40316,132981,65643,67338,97.5,140103,23499,955,131567,64919,66648
26123,Newaygo County,MI,48366,24285,24081,100.8,2786,2892,3286,2962,2706,5426,5274,6341,3982,3599,5425,2769,918,42.4,10937,37429,18690,18739,99.7,44979,595,186,36942,18439,18503
26125,Oakland County,MI,1253185,612894,640291,95.7,68056,69881,78350,77732,74902,163011,156899,180230,93850,85222,121096,57121,26835,40.9,266023,987162,476933,510229,93.5,940365,170488,93551,919598,440674,478924
26127,Oceana County,MI,26416,13381,13035,102.7,1446,1718,1810,1735,1622,2582,2779,3301,1994,2047,3209,1635,538,43.2,6069,20347,10293,10054,102.4,24986,293,63,19112,9501,9611
26129,Ogemaw County,MI,20898,10528,10370,101.5,965,1055,1122,1114,972,1964,2028,2580,1908,1915,3033,1679,563,50.4,3866,17032,8492,8540,99.4,20169,68,136,16915,8423,8492
26131,Ontonagon County,MI,5877,3012,2865,105.1,145,183,223,299,172,319,449,759,554,691,1213,669,201,58.6,726,5151,2638,2513,105.0,5640,29,25,5117,2623,2494
26133,Osceola County,MI,23290,11804,11486,102.8,1293,1391,1546,1570,1177,2495,2493,2964,1831,1727,2787,1496,520,43.8,5280,18010,9007,9003,100.0,22388,261,64,17954,8974,8980
26135,Oscoda County,MI,8248,4199,4049,103.7,432,423,459,410,387,719,674,932,793,792,1302,751,174,51.8,1580,6668,3328,3340,99.6,7981,44,12,6629,3325,3304
26137,Otsego County,MI,24490,12153,12337,98.5,1270,1483,1434,1503,1383,2662,2538,3359,2104,1678,3023,1440,613,44.9,5156,19334,9519,9815,97.0,23442,163,139,19267,9486,9781
26139,Ottawa County,MI,286558,141600,144958,97.7,17863,19120,20167,24541,26524,34231,33629,34376,17966,16248,24007,11883,6003,35.2,69280,217278,105970,111308,95.2,256755,4425,7747,210688,102387,108301
26141,Presque Isle County,MI,12714,6329,6385,99.1,495,516,607,641,522,892,1156,1520,1193,1280,2185,1262,445,55.0,2056,10658,5320,5338,99.7,12276,75,72,10595,5298,5297
26143,Roscommon County,MI,23851,11883,11968,99.3,874,1063,984,1061,956,1841,1880,2867,2048,2660,4537,2367,713,56.2,3657,20194,10011,10183,98.3,23020,39,69,20105,9984,10121
26145,Saginaw County,MI,191821,93128,98693,94.4,11023,11630,11187,13045,12973,23423,20939,24459,13996,13345,20276,10653,4872,40.9,41330,150491,71983,78508,91.7,144268,35664,2284,148373,70773,77600
26147,St. Clair County,MI,159247,79166,80081,98.9,7994,8401,10630,10011,9399,17416,18023,23454,12973,11910,17254,8357,3425,43.8,33584,125663,61782,63881,96.7,148933,3554,1026,124073,61113,62960
26149,St. Joseph County,MI,60836,30353,30483,99.6,4033,3961,4423,4037,3456,7303,7027,7424,4475,4130,6204,3180,1183,39.6,15006,45830,22635,23195,97.6,55964,1353,305,44367,22016,22351
26151,Sanilac County,MI,41295,20509,20786,98.7,2145,2530,2537,2597,2140,4165,4415,5478,3347,3263,4992,2729,957,45.2,8942,32353,16004,16349,97.9,39896,222,113,32010,15815,16195
26153,Schoolcraft County,MI,8048,3930,4118,95.4,335,401,393,417,335,625,776,1076,706,852,1263,610,259,52.1,1389,6659,3257,3402,95.7,6958,36,30,6650,3251,3399
26155,Shiawassee County,MI,68340,33776,34564,97.7,3575,3969,4157,4606,4016,7847,7941,9695,5297,5088,7195,3649,1305,42.4,14599,53741,26351,27390,96.2,65997,467,200,53461,26256,27205
26157,Tuscola County,MI,52939,26626,26313,101.2,2744,3087,3002,3271,2893,5832,5871,7311,4335,4087,6033,3353,1120,44.6,10960,41979,20832,21147,98.5,50849,531,181,41784,20739,21045
26159,Van Buren County,MI,75358,37494,37864,99.0,4576,4697,5307,4872,4221,8199,8861,9940,5488,5939,8095,3782,1381,41.6,17730,57628,28371,29257,97.0,64935,2520,534,55161,27071,28090
26161,Washtenaw County,MI,367000,181923,185077,98.3,18035,18129,20478,32890,48200,52402,42112,43337,21542,20567,29997,13542,5769,33.6,68876,298124,146639,151485,96.8,269998,43795,33476,275455,134919,140536
26163,Wayne County,MI,1757299,846179,911120,92.9,115383,113953,116063,113354,116561,243060,208587,232016,121898,111937,154219,75665,34603,37.9,417723,1339576,633149,706427,89.6,933616,680932,58915,1276349,601074,675275
26165,Wexford County,MI,33256,16599,16657,99.7,2011,2242,2260,1893,1772,3891,3665,4316,2343,2666,3634,1812,751,41.6,7759,25497,12690,12807,99.1,31836,245,180,25357,12639,12718
27001,Aitkin County,MN,15834,8047,7787,103.3,569,849,729,741,571,1229,1285,1826,1443,1448,2918,1741,485,55.5,2651,13183,6623,6560,101.0,15003,81,54,13128,6598,6530
27003,Anoka County,MN,350253,175259,174994,100.2,21878,22561,24861,22420,19925,46057,46539,50198,27069,21340,29205,13521,4679,38.5,84034,266219,132370,133849,98.9,292866,21877,15645,255988,127393,128595
27005,Becker County,MN,34011,16928,17083,99.1,2163,2572,2132,2139,1712,3577,3802,3879,2401,2758,4021,2071,784,41.9,8296,25715,12793,12922,99.0,29783,167,219,25570,12734,12836
27007,Beltrami County,MN,46403,23137,23266,99.4,3237,3566,3143,3468,4475,5781,5027,4765,2809,2916,4150,2228,838,34.0,11686,34717,17098,17619,97.0,33818,729,348,34438,16943,17495
27009,Benton County,MN,40129,20130,19999,100.7,2807,2802,3007,2284,2470,6155,5411,4871,2363,2432,2981,1578,968,36.0,10144,29985,15033,14952,100.5,36637,1601,408,29242,14615,14627
27011,Big Stone County,MN,4996,2488,2508,99.2,294,292,280,215,269,502,451,566,366,480,587,491,203,49.0,1033,3963,1959,2004,97.8,4878,3,3,3926,1945,1981
27013,Blue Earth County,MN,66795,33456,33339,100.4,3664,3831,3584,5932,10867,8905,7153,6542,3620,3766,4905,2741,1285,31.0,13210,53585,26681,26904,99.2,60604,2578,1443,51533,25548,25985
27015,Brown County,MN,25163,12610,12553,100.5,1390,1502,1637,1660,1635,2798,2663,2882,1890,1863,2626,1787,830,42.3,5462,19701,9686,10015,96.7,24021,181,166,19404,9493,9911
27017,Carlton County,MN,35633,18634,16999,109.6,1874,2302,2442,2164,1890,4252,4535,4906,2730,2481,3393,1746,918,41.0,8043,27590,14470,13120,110.3,31849,670,205,27406,14334,13072
27019,Carver County,MN,101949,50618,51331,98.6,6597,7939,8013,7637,5465,11035,14616,15601,7429,5989,6882,3455,1291,37.9,27508,74441,36561,37880,96.5,93751,1864,2893,72645,35600,37045
27021,Cass County,MN,29268,14967,14301,104.7,1649,1786,1754,1495,1251,2709,2759,3480,2353,2626,4458,2401,547,48.9,6187,23081,11700,11381,102.8,24720,122,187,22980,11640,11340
27023,Chippewa County,MN,11953,5912,6041,97.9,848,751,772,624,713,1392,1278,1368,836,875,1299,667,530,41.6,2789,9164,4464,4700,95.0,10775,103,105,8735,4264,4471
27025,Chisago County,MN,55315,28780,26535,108.5,3101,3099,4129,3548,3036,6663,7049,8432,4393,3600,5017,2250,998,41.3,12694,42621,22089,20532,107.6,52713,729,624,42278,21901,20377
27027,Clay County,MN,63446,31334,32112,97.6,4531,4660,3907,5449,6332,9059,7799,6623,3788,3104,4283,2564,1347,32.6,15508,47938,23384,24554,95.2,57471,2332,803,46686,22743,23943
27029,Clearwater County,MN,8821,4514,4307,104.8,552,573,686,565,416,905,1011,1019,729,577,960,561,267,42.3,2191,6630,3351,3279,102.2,7568,16,42,6587,3326,3261
27031,Cook County,MN,5376,2661,2715,98.0,237,188,255,198,216,610,533,656,536,481,953,375,138,52.6,823,4553,2253,2300,98.0,4634,4,50,4381,2186,2195
27033,Cottonwood County,MN,11299,5650,5649,100.0,774,812,709,645,549,1169,1142,1354,780,797,1269,802,497,42.9,2744,8555,4208,4347,96.8,10101,107,450,8030,3891,4139
27035,Crow Wing County,MN,64217,31961,32256,99.1,3524,4105,3975,3549,3172,7113,6979,7881,4681,5105,8077,4379,1677,44.5,13969,50248,24795,25453,97.4,61499,526,272,49997,24666,25331
27037,Dakota County,MN,421453,207870,213583,97.3,27329,28266,30104,27030,24293,55212,56009,58686,31722,25377,34649,16200,6576,37.9,103466,317987,154644,163343,94.7,345909,26362,20348,301513,146177,155336
27039,Dodge County,MN,20669,10393,10276,101.1,1307,1503,1654,1451,1148,2359,2742,2826,1432,1266,1670,919,392,38.4,5431,15238,7609,7629,99.7,19571,69,191,14887,7435,7452
27041,Douglas County,MN,37513,18768,18745,100.1,2127,2218,2447,1917,1955,4332,4090,4315,2929,2763,4553,2728,1139,44.2,8064,29449,14700,14749,99.7,36341,145,121,29322,14648,14674
27043,Faribault County,MN,13801,6920,6881,100.6,822,840,826,803,647,1390,1461,1669,1089,1120,1567,981,586,45.8,3036,10765,5320,5445,97.7,13350,35,51,10567,5207,5360
27045,Fillmore County,MN,20949,10542,10407,101.3,1355,1514,1445,1229,971,2181,2362,2502,1502,1589,2243,1311,745,42.3,5119,15830,7856,7974,98.5,20442,107,105,15657,7738,7919
27047,Freeborn County,MN,30463,15155,15308,99.0,1694,2016,1842,1722,1417,3470,3303,3752,2413,2135,3446,2167,1086,44.0,6686,23777,11739,12038,97.5,27894,330,777,22802,11310,11492
27049,Goodhue County,MN,46246,22975,23271,98.7,2622,2853,3052,2725,2314,5371,5402,5966,3543,3618,4832,2532,1416,42.2,10360,35886,17664,18222,96.9,43474,606,383,35128,17271,17857
27051,Grant County,MN,5935,3001,2934,102.3,347,372,418,268,298,598,670,673,520,389,721,465,196,44.9,1329,4606,2328,2278,102.2,5743,17,2,4574,2307,2267
27053,Hennepin County,MN,1245837,616042,629795,97.8,80799,77623,73251,71688,78306,212073,167423,156388,83338,74530,99547,47445,23426,36.5,274740,971097,476298,494799,96.3,897639,165152,89004,894636,436049,458587
27055,Houston County,MN,18648,9368,9280,100.9,1022,1163,1170,1028,936,1877,2063,2373,1600,1545,2131,1182,558,45.3,4039,14609,7267,7342,99.0,18069,243,72,14557,7234,7323
27057,Hubbard County,MN,21019,10627,10392,102.3,1133,1294,1300,1075,907,1876,2165,2537,1656,1853,3118,1568,537,48.7,4442,16577,8376,8201,102.1,19634,135,140,16414,8270,8144
27059,Isanti County,MN,39430,19973,19457,102.7,2342,2603,2869,2435,2116,5073,4798,5459,3052,2561,3511,1844,767,40.0,9404,30026,15087,14939,101.0,37510,192,576,29844,15018,14826
27061,Itasca County,MN,45141,22863,22278,102.6,2388,2825,2528,2693,2115,4369,4981,5552,3634,3840,5914,2985,1317,46.3,9486,35655,17851,17804,100.3,41877,222,192,35476,17757,17719
27063,Jackson County,MN,9954,5089,4865,104.6,563,535,643,590,484,1025,1176,1216,817,753,1038,768,346,44.8,2149,7805,3966,3839,103.3,9403,39,208,7633,3877,3756
27065,Kanabec County,MN,16089,8136,7953,102.3,828,922,1091,950,843,1583,1821,2151,1335,1314,1931,933,387,45.0,3464,12625,6375,6250,102.0,15435,35,92,12591,6343,6248
27067,Kandiyohi County,MN,42841,21565,21276,101.4,2902,2965,2984,2452,2733,5210,4716,4885,3153,2987,4317,2362,1175,39.3,10447,32394,16116,16278,99.0,37829,2285,444,30492,15083,15409
27069,Kittson County,MN,4311,2169,2142,101.3,244,259,250,242,239,361,421,525,373,365,521,323,188,48.1,928,3383,1699,1684,100.9,4150,64,29,3345,1684,1661
27071,Koochiching County,MN,12515,6238,6277,99.4,508,697,621,766,563,1161,1261,1628,1163,1093,1697,820,537,49.5,2290,10225,5076,5149,98.6,11711,73,49,9937,5022,4915
27073,Lac qui Parle County,MN,6719,3368,3351,100.5,310,390,366,365,316,546,672,801,608,554,849,631,311,50.4,1304,5415,2702,2713,99.6,6452,58,57,5338,2659,2679
27075,Lake County,MN,10560,5424,5136,105.6,489,549,498,491,429,1010,1136,1329,948,963,1459,882,377,50.8,1854,8706,4449,4257,104.5,10234,68,14,8673,4428,4245
27077,Lake of the Woods County,MN,3771,2009,1762,114.0,210,160,262,189,142,326,403,449,320,424,511,253,122,50.9,799,2972,1568,1404,111.7,3508,2,3,2964,1565,1399
27079,Le Sueur County,MN,28242,14153,14089,100.5,1736,1797,2092,1762,1520,3067,3483,3902,2288,1766,2753,1493,583,41.0,6792,21450,10738,10712,100.2,26972,238,115,21011,10526,10485
27081,Lincoln County,MN,5677,2860,2817,101.5,346,400,371,299,272,547,582,640,431,391,623,462,313,45.4,1320,4357,2178,2179,100.0,5533,25,9,4329,2156,2173
27083,Lyon County,MN,25758,12830,12928,99.2,1866,1795,1842,1968,1859,3144,3055,3004,1750,1489,2068,1228,690,35.8,6556,19202,9427,9775,96.4,22201,891,1117,18304,8971,9333
27085,McLeod County,MN,35832,17955,17877,100.4,2077,2341,2411,2232,2037,4281,4274,4759,2446,2429,3477,2224,844,40.7,8306,27526,13626,13900,98.0,34034,212,210,26921,13292,13629
27087,Mahnomen County,MN,5501,2788,2713,102.8,482,545,462,408,259,543,561,570,363,344,533,324,107,35.7,1739,3762,1862,1900,98.0,2572,29,19,3754,1859,1895
27089,Marshall County,MN,9372,4735,4637,102.1,561,602,616,548,500,990,975,1179,725,704,986,698,288,43.7,2137,7235,3697,3538,104.5,9073,33,33,7173,3667,3506
27091,Martin County,MN,19852,9952,9900,100.5,1073,1476,1079,1106,1063,2203,1861,2236,1689,1511,2268,1462,825,45.3,4329,15523,7645,7878,97.0,19117,92,102,15445,7618,7827
27093,Meeker County,MN,23105,11800,11305,104.4,1413,1475,1747,1477,1226,2275,2661,2830,1793,1722,2472,1393,621,42.2,5624,17481,8854,8627,102.6,22410,98,71,17262,8753,8509
27095,Mille Lacs County,MN,25865,13001,12864,101.1,1662,1809,1615,1653,1318,3033,3044,3380,1912,1768,2604,1465,602,40.5,6231,19634,9766,9868,99.0,23321,120,175,19476,9713,9763
27097,Morrison County,MN,33064,16679,16385,101.8,1921,2280,2227,1974,1699,3650,3800,4244,2535,2467,3397,1955,915,41.7,7741,25323,12649,12674,99.8,31845,185,144,25127,12519,12608
27099,Mower County,MN,39807,20058,19749,101.6,2588,3011,2694,2542,2135,4696,5003,4646,2748,2438,3625,2412,1269,38.8,9945,29862,14847,15015,98.9,34533,1570,1468,27234,13388,13846
27101,Murray County,MN,8296,4149,4147,100.0,438,525,526,445,390,752,839,968,667,643,1087,671,345,48.1,1781,6515,3245,3270,99.2,8002,31,132,6336,3156,3180
27103,Nicollet County,MN,33954,17018,16936,100.5,1982,2177,2055,2736,2843,4507,4155,3860,2126,2196,3003,1537,777,36.3,7469,26485,13329,13156,101.3,31228,958,592,25640,12948,12692
27105,Nobles County,MN,21734,11256,10478,107.4,1825,1675,1573,1338,1337,2872,2455,2405,1359,1407,1794,1033,661,35.7,5905,15829,8231,7598,108.3,16901,928,1508,13193,6771,6422
27107,Norman County,MN,6520,3320,3200,103.8,357,414,468,444,328,583,750,812,484,484,700,444,252,43.8,1537,4983,2516,2467,102.0,6080,65,26,4913,2475,2438
27109,Olmsted County,MN,154809,75648,79161,95.6,10820,10738,10524,9102,8932,22445,20140,18657,11095,9008,12780,7216,3352,37.2,38129,116680,56267,60413,93.1,129616,9566,9028,109372,52392,56980
27111,Otter Tail County,MN,58195,29326,28869,101.6,3403,3688,3402,3326,2889,5499,5912,6914,4654,4929,7458,4157,1964,46.8,12635,45560,22807,22753,100.2,55244,870,348,44870,22478,22392
27113,Pennington County,MN,14183,7055,7128,99.0,934,918,905,855,823,1851,1688,1705,978,981,1350,889,306,39.6,3313,10870,5381,5489,98.0,13329,153,165,10757,5329,5428
27115,Pine County,MN,29223,15601,13622,114.5,1372,1609,1746,1714,1450,3176,3541,3987,2493,2261,3374,1937,563,45.0,5810,23413,12547,10866,115.5,26701,658,164,23311,12490,10821
27117,Pipestone County,MN,9191,4484,4707,95.3,611,651,687,620,413,1013,878,1133,633,649,894,628,381,42.1,2345,6846,3271,3575,91.5,8460,120,15,6560,3137,3423
27119,Polk County,MN,31521,16038,15483,103.6,2164,2068,2171,2056,1867,3943,3357,3810,2279,2132,3030,1729,915,38.7,7610,23911,11999,11912,100.7,28896,686,312,23358,11772,11586
27121,Pope County,MN,11048,5587,5461,102.3,626,686,618,579,489,1251,1157,1250,919,854,1435,783,401,45.8,2319,8729,4353,4376,99.5,10666,46,63,8648,4313,4335
27123,Ramsey County,MN,544442,265450,278992,95.1,38021,35519,33943,34718,39103,90568,66675,62344,35030,31783,44300,21187,11251,35.0,127038,417404,200496,216908,92.4,361226,65848,78585,384281,183087,201194
27125,Red Lake County,MN,4015,2041,1974,103.4,260,263,288,248,154,386,522,469,320,303,424,237,141,42.7,985,3030,1526,1504,101.5,3821,20,0,3013,1513,1500
27127,Redwood County,MN,15261,7706,7555,102.0,927,1024,1122,954,804,1587,1564,1869,1138,1054,1613,1009,596,42.6,3707,11554,5808,5746,101.1,13428,119,409,11421,5752,5669
27129,Renville County,MN,14652,7456,7196,103.6,890,926,1010,841,764,1539,1570,1778,1242,1090,1503,958,541,43.8,3374,11278,5722,5556,103.0,13095,56,100,10985,5571,5414
27131,Rice County,MN,66185,33765,32420,104.1,3758,4087,4237,5535,6715,7451,7724,8279,4266,4107,5763,2925,1338,36.5,14519,51666,26497,25169,105.3,56681,3765,1411,48426,24661,23765
27133,Rock County,MN,9402,4601,4801,95.8,631,655,710,593,454,1006,1066,1121,645,655,945,543,378,40.8,2395,7007,3442,3565,96.5,9064,87,100,6955,3411,3544
27135,Roseau County,MN,15361,7910,7451,106.2,897,1079,1095,1022,879,1500,1807,2177,1229,1114,1431,774,357,41.6,3752,11609,5974,5635,106.0,14214,146,416,11428,5902,5526
27137,St. Louis County,MN,199759,100118,99641,100.5,10171,9893,11560,13836,18051,22928,22185,23329,14838,15341,21622,10863,5142,41.1,38122,161637,80577,81060,99.4,183938,3154,2060,159674,79702,79972
27139,Scott County,MN,145275,72365,72910,99.3,10147,11433,11843,10454,7765,17679,21541,22124,9770,7382,9347,3833,1957,36.5,40475,104800,51912,52888,98.2,121973,6199,8845,100515,49898,50617
27141,Sherburne County,MN,94463,48249,46214,104.4,6230,7824,6651,6651,5475,12768,13421,13847,6752,4583,6437,2712,1112,36.0,25163,69300,35435,33865,104.6,87265,2335,1213,68045,34701,33344
27143,Sibley County,MN,14892,7581,7311,103.7,847,1059,989,953,730,1649,1787,1971,1180,1035,1396,870,426,41.7,3527,11365,5758,5607,102.7,14199,157,107,10819,5449,5370
27145,Stearns County,MN,158452,79704,78748,101.2,10195,10089,10140,13333,16747,19582,17609,18414,9837,9418,12717,7065,3306,34.4,36658,121794,61152,60642,100.8,139188,10217,3304,116830,58575,58255
27147,Steele County,MN,36683,18200,18483,98.5,2290,2539,2849,2402,2024,4320,4289,4730,2578,2410,3293,2033,926,39.0,9201,27482,13671,13811,99.0,33193,1158,547,26692,13244,13448
27149,Stevens County,MN,9789,4908,4881,100.6,554,540,642,927,1291,1167,977,912,605,525,777,513,359,33.1,2073,7716,3811,3905,97.6,8846,195,232,7326,3557,3769
27151,Swift County,MN,9359,4686,4673,100.3,534,561,660,526,426,1057,1055,1118,696,682,1023,661,360,43.9,2113,7246,3575,3671,97.4,8845,206,27,7051,3473,3578
27153,Todd County,MN,24494,12591,11903,105.8,1655,1586,1624,1438,1304,2354,2568,3019,1821,2004,2862,1636,623,43.9,5829,18665,9511,9154,103.9,23109,173,157,18046,9170,8876
27155,Traverse County,MN,3311,1644,1667,98.6,160,190,165,149,131,420,344,408,270,252,354,268,200,47.5,652,2659,1337,1322,101.1,3003,17,6,2634,1314,1320
27157,Wabasha County,MN,21537,10849,10688,101.5,1185,1214,1422,1237,1036,2291,2322,2955,1738,1575,2540,1551,471,45.2,4629,16908,8462,8446,100.2,20773,126,103,16730,8384,8346
27159,Wadena County,MN,13654,6739,6915,97.5,936,992,952,849,679,1465,1463,1557,907,991,1458,956,449,41.5,3455,10199,4970,5229,95.0,12982,82,57,10069,4857,5212
27161,Waseca County,MN,18740,9005,9735,92.5,1080,1195,1281,1243,1026,2359,2446,2262,1164,1425,1800,974,485,40.5,4375,14365,6852,7513,91.2,17409,444,113,14013,6769,7244
27163,Washington County,MN,255938,126626,129312,97.9,15329,17827,18443,17457,14323,29694,33521,36890,19159,16385,22181,10645,4084,39.5,63068,192870,94553,98317,96.2,218513,11757,14773,187071,91607,95464
27165,Watonwan County,MN,10972,5511,5461,100.9,830,719,713,728,560,1300,1160,1210,810,753,1022,696,471,39.9,2685,8287,4088,4199,97.4,9411,102,129,7428,3615,3813
27167,Wilkin County,MN,6291,3245,3046,106.5,367,378,417,414,329,642,717,830,523,493,590,324,267,43.3,1428,4863,2475,2388,103.6,6181,25,1,4856,2469,2387
27169,Winona County,MN,50725,25126,25599,98.2,2443,2478,2588,4924,6900,5926,5003,5520,3406,3206,4693,2690,948,35.2,9161,41564,20475,21089,97.1,47455,651,1340,40534,19847,20687
27171,Wright County,MN,134438,67939,66499,102.2,9429,10723,11248,9453,6785,15976,19372,18956,8916,7219,9791,4635,1935,37.0,37821,96617,48376,48241,100.3,126547,1905,1495,95086,47679,47407
27173,Yellow Medicine County,MN,9814,4984,4830,103.2,611,630,626,602,516,1088,1091,1157,701,814,937,698,343,42.4,2261,7553,3823,3730,102.5,9090,68,60,7451,3771,3680
28001,Adams County,MS,31266,16132,15134,106.6,1905,1614,1870,1694,1882,3880,4112,3800,2407,2386,3257,1838,621,41.4,6488,24778,12813,11965,107.1,12796,17610,187,22666,10713,11953
28003,Alcorn County,MS,37090,18218,18872,96.5,2178,2523,2274,2531,2060,4656,4689,4688,2571,2165,3881,2114,760,39.7,8654,28436,13675,14761,92.6,31319,4492,110,28200,13573,14627
28005,Amite County,MS,12412,6013,6399,94.0,673,732,699,759,523,1338,1191,1560,1263,848,1699,812,315,47.1,2567,9845,4725,5120,92.3,7119,5202,23,9808,4723,5085
28007,Attala County,MS,18437,8718,9719,89.7,1185,1125,1579,1256,1006,2044,2011,2354,1157,1210,2050,1048,412,39.8,4668,13769,6447,7322,88.0,9916,7792,44,13690,6441,7249
28009,Benton County,MS,8232,4046,4186,96.7,314,466,662,699,398,817,1142,1012,686,606,785,498,147,41.5,1769,6463,3196,3267,97.8,5051,2813,0,6392,3177,3215
28011,Bolivar County,MS,31848,15012,16836,89.2,2184,2252,2195,2324,2275,4380,3742,3742,1919,2055,3008,1221,551,35.6,7916,23932,10873,13059,83.3,10497,20453,286,23505,10714,12791
28013,Calhoun County,MS,14499,6917,7582,91.2,859,666,1335,937,836,1597,1651,1936,940,1079,1459,849,355,41.4,3444,11055,5159,5896,87.5,9459,3968,34,10743,4985,5758
28015,Carroll County,MS,10070,5082,4988,101.9,451,536,675,647,463,854,1126,1443,886,688,1373,616,312,47.6,1938,8132,4103,4029,101.8,6499,3499,0,8129,4100,4029
28017,Chickasaw County,MS,17193,8291,8902,93.1,1251,1099,1259,1145,1089,2126,1912,2233,954,1231,1714,863,317,37.8,4294,12899,6161,6738,91.4,8651,7616,33,12646,5993,6653
28019,Choctaw County,MS,8277,4158,4119,100.9,424,602,490,576,401,819,975,1036,555,628,1005,573,193,44.0,1815,6462,3099,3363,92.1,5611,2566,2,6459,3096,3363
28021,Claiborne County,MS,9089,4262,4827,88.3,546,389,679,1339,928,785,975,877,536,583,881,420,151,33.9,1976,7113,3280,3833,85.6,1028,7928,103,7075,3253,3822
28023,Clarke County,MS,15770,7373,8397,87.8,902,893,1101,1061,918,1870,1651,1954,1139,1134,1820,1026,301,42.2,3531,12239,5708,6531,87.4,10028,5592,0,12239,5708,6531
28025,Clay County,MS,19640,9144,10496,87.1,1118,1180,1409,1440,1091,2484,2299,2359,1246,1507,2115,810,582,39.5,4528,15112,6946,8166,85.1,7622,11784,57,15060,6902,8158
28027,Coahoma County,MS,23255,10743,12512,85.9,1902,1707,1712,1873,1618,2874,2544,2661,1458,1506,1998,927,475,34.8,6355,16900,7560,9340,80.9,4860,18050,115,16846,7520,9326
28029,Copiah County,MS,28501,13601,14900,91.3,1746,1941,1773,2175,1943,3428,3246,3478,2173,1804,2834,1445,515,38.5,6613,21888,10313,11575,89.1,12849,14698,108,21676,10218,11458
28031,Covington County,MS,18978,9253,9725,95.1,1292,1405,1239,1328,1262,2188,2368,2221,1389,1065,1822,997,402,37.3,4706,14272,6788,7484,90.7,11886,6946,0,14202,6765,7437
28033,DeSoto County,MS,178975,86292,92683,93.1,10971,12395,14261,13426,11077,22929,25481,25033,11319,9452,14092,6482,2057,36.8,46377,132598,62708,69890,89.7,119455,48835,2524,129340,61139,68201
28035,Forrest County,MS,75224,35722,39502,90.4,5018,4773,4925,5715,7971,11265,8938,8375,3604,4644,5735,2911,1350,32.5,17446,57778,26737,31041,86.1,44649,27951,639,56555,26159,30396
28037,Franklin County,MS,7733,3696,4037,91.6,428,343,792,416,452,803,929,897,568,616,836,529,124,42.5,1834,5899,2834,3065,92.5,4903,2782,4,5887,2833,3054
28039,George County,MS,23917,12034,11883,101.3,1738,1817,1506,1808,1477,3246,2825,3120,1619,1244,2195,948,374,36.4,6341,17576,8985,8591,104.6,21255,1920,107,17418,8846,8572
28041,Greene County,MS,13645,8156,5489,148.6,641,791,679,748,990,1929,2110,2138,936,855,1104,566,158,40.4,2649,10996,6775,4221,160.5,10021,3538,0,10765,6694,4071
28043,Grenada County,MS,21088,10047,11041,91.0,1338,1443,1397,1445,1183,2558,2527,2685,1659,1179,2148,1028,498,39.2,5018,16070,7466,8604,86.8,11577,9161,46,16019,7437,8582
28045,Hancock County,MS,46961,22974,23987,95.8,2629,2592,2761,2807,2516,5187,5572,6625,3653,3355,5686,2777,801,44.4,9851,37110,17761,19349,91.8,41108,3765,281,36812,17606,19206
28047,Harrison County,MS,204502,100358,104144,96.4,13515,14270,13505,13451,14413,29264,25180,25253,13800,12266,17916,8858,2811,36.2,49289,155213,75137,80076,93.8,138940,50994,5813,151075,72988,78087
28049,Hinds County,MS,238797,111362,127435,87.4,15584,15811,17078,17948,18854,34559,28709,27931,15679,14087,19373,8899,4285,34.8,58457,180340,81785,98555,83.0,60513,173413,1851,178155,80560,97595
28051,Holmes County,MS,17737,8483,9254,91.7,1205,1417,1192,1476,1471,2169,1941,2029,1164,1097,1460,838,278,34.7,4598,13139,6057,7082,85.5,2749,14903,12,13139,6057,7082
28053,Humphreys County,MS,8389,4011,4378,91.6,514,769,594,543,566,935,843,1035,633,587,792,392,186,38.3,2249,6140,2851,3289,86.7,1743,6375,7,5992,2740,3252
28055,Issaquena County,MS,1361,841,520,161.7,92,60,31,16,52,283,225,153,157,72,115,91,14,42.2,199,1162,738,424,174.1,514,839,0,1162,738,424
28057,Itawamba County,MS,23462,11835,11627,101.8,1251,1366,1587,1902,1640,2825,2743,3098,1538,1452,2281,1236,543,39.9,5114,18348,9030,9318,96.9,21363,1709,6,18303,9002,9301
28059,Jackson County,MS,142376,70281,72095,97.5,8105,8905,10444,9249,8569,18192,18546,19179,9860,9139,13249,7008,1931,38.8,33594,108782,52758,56024,94.2,100751,30305,3434,106542,51868,54674
28061,Jasper County,MS,16505,8035,8470,94.9,1021,1005,1104,927,1093,1817,1844,2076,995,1377,1842,1140,264,41.0,3747,12758,6112,6646,92.0,7379,8964,0,12758,6112,6646
28063,Jefferson County,MS,7225,3534,3691,95.7,452,424,534,385,570,745,1072,834,547,552,648,293,169,40.5,1680,5545,2739,2806,97.6,959,6198,43,5479,2718,2761
28065,Jefferson Davis County,MS,11339,5421,5918,91.6,521,640,744,622,856,978,1454,1401,865,781,1463,805,209,44.0,2284,9055,4219,4836,87.2,4303,6950,14,9055,4219,4836
28067,Jones County,MS,68352,33384,34968,95.5,4829,5051,4633,4875,4037,8707,7942,8043,4363,4649,6501,3355,1367,37.5,17333,51019,24324,26695,91.1,46881,20077,225,49551,23374,26177
28069,Kemper County,MS,9943,5059,4884,103.6,419,417,619,1032,706,1208,1071,1256,855,435,1075,746,104,41.4,1881,8062,3973,4089,97.2,3433,6134,7,8055,3966,4089
28071,Lafayette County,MS,53590,25822,27768,93.0,2849,2919,2495,5924,8021,7660,6583,5129,2868,2637,3980,1729,796,30.5,9877,43713,21039,22674,92.8,38275,12657,1116,42596,20403,22193
28073,Lamar County,MS,61969,29581,32388,91.3,4050,4381,4567,3800,4115,9200,8814,7784,3837,3279,4777,2572,793,35.9,15561,46408,21804,24604,88.6,47370,12446,799,45563,21561,24002
28075,Lauderdale County,MS,76279,37112,39167,94.8,4723,5131,5127,4996,4947,10093,9046,9563,4836,5156,7182,3713,1766,37.8,18047,58232,27804,30428,91.4,41343,33333,505,57339,27256,30083
28077,Lawrence County,MS,12633,6170,6463,95.5,787,798,990,951,557,1443,1533,1550,909,902,1314,688,211,39.9,3091,9542,4580,4962,92.3,8215,4109,28,9487,4563,4924
28079,Leake County,MS,22792,11746,11046,106.3,1396,1500,1910,1868,1399,2752,2821,2689,1626,1217,2082,1184,348,36.9,6070,16722,8181,8541,95.8,11677,9555,117,16435,8042,8393
28081,Lee County,MS,85072,40571,44501,91.2,5777,6096,6055,5663,5042,11242,11156,11135,5772,4762,7263,3871,1238,37.5,21629,63443,29619,33824,87.6,56904,25089,833,62231,28917,33314
28083,Leflore County,MS,29222,13623,15599,87.3,2193,2358,2310,2207,2351,3757,3381,3173,1633,1824,2302,1175,558,34.0,8136,21086,9491,11595,81.9,7009,21683,176,20778,9309,11469
28085,Lincoln County,MS,34320,16278,18042,90.2,2167,2332,2282,2359,1923,4058,4365,4467,2305,2326,3357,1924,455,38.9,8215,26105,12252,13853,88.4,23159,10957,165,25992,12169,13823
28087,Lowndes County,MS,59150,28141,31009,90.8,3884,3935,3850,3939,4233,8117,6925,7260,4305,3546,5411,2785,960,37.1,14009,45141,20869,24272,86.0,31595,25902,602,44714,20671,24043
28089,Madison County,MS,104562,49973,54589,91.5,6613,7711,7457,7190,6538,13516,14392,14071,7211,6456,8526,3221,1660,37.2,26301,78261,36652,41609,88.1,59828,39731,2699,76206,35651,40555
28091,Marion County,MS,24990,12102,12888,93.9,1447,1588,1747,1697,1545,2854,3040,3152,1718,1702,2560,1312,628,40.8,5756,19234,9312,9922,93.9,16308,8140,131,19039,9134,9905
28093,Marshall County,MS,35599,17559,18040,97.3,2020,2091,2163,2462,2399,4093,4308,4801,2868,2351,3935,1709,399,40.4,7599,28000,13761,14239,96.6,17616,17017,0,27624,13589,14035
28095,Monroe County,MS,35673,17002,18671,91.1,2082,2085,2528,2093,2123,4319,4089,4658,2205,2720,3906,2112,753,41.1,8103,27570,12917,14653,88.2,24288,11132,31,27453,12856,14597
28097,Montgomery County,MS,10068,4686,5382,87.1,601,602,715,441,527,1292,1135,1186,729,752,1192,686,210,41.6,2287,7781,3686,4095,90.0,5324,4446,29,7704,3609,4095
28099,Neshoba County,MS,29332,13988,15344,91.2,2028,2242,2439,2214,1825,3277,3588,3519,2038,1561,2708,1420,473,37.3,8104,21228,9950,11278,88.2,17593,6145,159,20889,9770,11119
28101,Newton County,MS,21360,10042,11318,88.7,1339,1378,1793,1788,1366,2447,2604,2726,1191,1285,1989,1024,430,37.0,5414,15946,7422,8524,87.1,13115,6515,111,15835,7341,8494
28103,Noxubee County,MS,10700,4993,5707,87.5,783,686,644,846,798,1337,1079,1348,833,640,985,442,279,37.0,2681,8019,3718,4301,86.4,2916,7721,5,7956,3680,4276
28105,Oktibbeha County,MS,49512,24737,24775,99.8,2568,2249,2452,5981,10430,7194,4691,3915,2184,2386,3150,1719,593,26.1,8621,40891,20335,20556,98.9,28406,18312,1635,39385,19441,19944
28107,Panola County,MS,34190,16482,17708,93.1,2475,2335,2327,2146,2282,4496,4051,4326,2330,2173,3134,1695,420,38.3,8571,25619,12080,13539,89.2,16647,16616,5,25228,11862,13366
28109,Pearl River County,MS,55219,27311,27908,97.9,3082,3396,3736,3868,3362,6464,6282,7242,3529,4094,6197,2811,1156,40.9,12414,42805,20863,21942,95.1,46246,7055,137,42422,20651,21771
28111,Perry County,MS,12006,5847,6159,94.9,719,760,818,914,613,1234,1612,1510,881,877,1230,656,182,41.9,2781,9225,4413,4812,91.7,9488,2379,18,9203,4393,4810
28113,Pike County,MS,39532,18741,20791,90.1,2695,3409,2534,2839,2607,4573,4554,4618,2794,2338,3875,2005,691,37.2,10400,29132,13455,15677,85.8,17315,21456,125,28981,13327,15654
28115,Pontotoc County,MS,31618,15292,16326,93.7,2230,2506,2228,2149,1912,4076,3777,4238,2086,1775,2629,1270,742,36.6,8409,23209,11283,11926,94.6,24564,5068,25,22407,10764,11643
28117,Prentiss County,MS,25255,12146,13109,92.7,1560,1770,1500,1716,1775,3052,3032,3218,1552,1633,2436,1525,486,39.2,5718,19537,9326,10211,91.3,21115,2533,554,19278,9209,10069
28119,Quitman County,MS,7187,3362,3825,87.9,448,481,495,396,532,829,845,955,435,577,698,364,132,38.7,1695,5492,2494,2998,83.2,1939,5176,16,5479,2481,2998
28121,Rankin County,MS,152677,73629,79048,93.1,9170,9357,10916,9658,8621,21526,21826,20319,9938,8846,13508,6761,2231,37.8,35816,116861,55346,61515,90.0,115371,31723,1765,114741,54354,60387
28123,Scott County,MS,28332,14052,14280,98.4,1889,2135,2289,1905,1662,3715,3654,3373,1626,1867,2550,1284,383,36.4,7531,20801,9906,10895,90.9,16211,10791,73,19314,8959,10355
28125,Sharkey County,MS,4404,2036,2368,86.0,217,372,279,339,274,388,512,543,366,313,473,220,108,41.2,1073,3331,1470,1861,79.0,1104,3284,0,3293,1453,1840
28127,Simpson County,MS,26888,12997,13891,93.6,1529,1758,2026,1698,1652,3417,3152,3275,1897,1870,2676,1431,507,39.5,6453,20435,9708,10727,90.5,16625,9851,149,20400,9684,10716
28129,Smith County,MS,16009,7824,8185,95.6,900,1303,890,1095,828,1804,1883,2034,1149,1090,1782,940,311,41.5,3817,12192,5804,6388,90.9,12129,3675,85,12139,5754,6385
28131,Stone County,MS,18276,9199,9077,101.3,976,1213,1134,1401,1464,2092,2312,2414,932,1405,1799,955,179,38.7,3966,14310,7136,7174,99.5,14300,3351,0,14253,7098,7155
28133,Sunflower County,MS,26168,13867,12301,112.7,1559,1609,1823,1709,1971,4255,3344,3430,1614,1470,2000,1002,382,35.6,5983,20185,10881,9304,116.9,6595,19332,20,20109,10838,9271
28135,Tallahatchie County,MS,14158,7851,6307,124.5,764,714,857,700,1281,2391,2156,1541,856,834,1215,624,225,36.8,2817,11341,6467,4874,132.7,5013,7599,198,10965,6117,4848
28137,Tate County,MS,28404,13676,14728,92.9,1637,1867,1870,2922,1490,3511,3178,3678,2051,1620,2852,1215,513,38.2,6573,21831,10325,11506,89.7,18895,8494,41,21613,10227,11386
28139,Tippah County,MS,22018,10641,11377,93.5,1380,1271,1756,1675,1612,2291,2756,2939,1644,1245,2094,1035,320,38.8,5380,16638,7949,8689,91.5,17041,3686,63,16430,7876,8554
28141,Tishomingo County,MS,19441,9544,9897,96.4,1079,1205,1216,1195,1099,2176,2172,2584,1346,1379,2296,1268,426,42.5,4230,15211,7344,7867,93.4,18680,516,5,15140,7316,7824
28143,Tunica County,MS,9988,4659,5329,87.4,940,766,766,595,247,1789,1695,857,439,720,833,266,75,33.6,2944,7044,3205,3839,83.5,1911,7838,140,6826,3092,3734
28145,Union County,MS,28507,14012,14495,96.7,1825,2236,1885,1793,1715,3681,3661,3645,1573,1814,2682,1581,416,37.9,7158,21349,10375,10974,94.5,22559,4424,102,20879,10039,10840
28147,Walthall County,MS,14477,7214,7263,99.3,852,1007,889,1089,936,1302,1908,1725,1094,909,1472,1016,278,39.8,3367,11110,5289,5821,90.9,7665,6706,15,11083,5280,5803
28149,Warren County,MS,46519,22208,24311,91.3,2943,3034,3191,3100,2831,5713,5784,5868,3058,3527,4585,2054,831,39.1,11181,35338,16559,18779,88.2,22470,22978,332,35086,16472,18614
28151,Washington County,MS,46057,21501,24556,87.6,3454,3151,3365,3181,3058,5629,5107,5635,3075,3305,4367,2058,672,37.2,12034,34023,15461,18562,83.3,11807,33235,260,33778,15322,18456
28153,Wayne County,MS,20373,10074,10299,97.8,1390,1275,1524,1266,1557,2124,2534,2501,1410,1377,1953,1166,296,40.2,5028,15345,7265,8080,89.9,11695,8359,26,15256,7195,8061
28155,Webster County,MS,9768,4753,5015,94.8,569,655,679,648,588,1019,1173,1350,732,604,1009,545,197,40.5,2317,7451,3570,3881,92.0,7697,1995,34,7451,3570,3881
28157,Wilkinson County,MS,8875,4870,4005,121.6,507,579,453,444,662,1311,1111,1062,561,688,928,419,150,37.8,1898,6977,3788,3189,118.8,2475,6307,10,6977,3788,3189
28159,Winston County,MS,18229,8851,9378,94.4,930,1079,1338,1090,1033,2065,2204,2272,1124,1456,2042,1010,586,42.3,4077,14152,6774,7378,91.8,9197,8553,6,14102,6724,7378
28161,Yalobusha County,MS,12367,5982,6385,93.7,771,768,782,707,758,1340,1401,1576,784,1041,1474,791,174,42.5,2794,9573,4488,5085,88.3,7302,4904,19,9563,4478,5085
28163,Yazoo County,MS,28565,16638,11927,139.5,1649,1885,1781,1451,2066,4991,4488,3445,1773,1397,2053,1050,536,36.1,6364,22201,13123,9078,144.6,10533,17027,126,21311,12338,8973
29001,Adair County,MO,25369,12321,13048,94.4,1320,1320,1241,2881,5071,2753,2058,2407,1524,1138,2011,1034,611,27.6,4728,20641,9749,10892,89.5,23240,680,638,19817,9323,10494
29003,Andrew County,MO,17503,8740,8763,99.7,995,946,1323,1111,929,1949,2095,2297,1417,1162,1845,1008,426,42.4,4035,13468,6658,6810,97.8,16686,240,61,13426,6654,6772
29005,Atchison County,MO,5229,2597,2632,98.7,258,266,305,269,227,549,548,697,375,408,723,389,215,48.5,1010,4219,2079,2140,97.1,5103,24,25,4193,2065,2128
29007,Audrain County,MO,25644,11825,13819,85.6,1597,1397,1773,1753,1549,3329,3039,3315,1549,1901,2496,1368,578,39.7,5927,19717,8601,11116,77.4,22789,1464,33,19522,8476,11046
29009,Barry County,MO,35530,17731,17799,99.6,2053,2235,2381,2223,1778,3759,3871,4569,2569,2909,4129,2345,709,43.7,8054,27476,13425,14051,95.5,32723,80,497,26392,12946,13446
29011,Barton County,MO,11797,5818,5979,97.3,660,722,815,869,651,1148,1414,1426,1015,705,1287,793,292,41.3,2809,8988,4360,4628,94.2,10959,35,4,8915,4304,4611
29013,Bates County,MO,16296,7993,8303,96.3,987,1088,1090,1019,854,1834,1830,2067,1196,1192,1682,1127,330,41.6,3856,12440,6046,6394,94.6,15542,246,47,12402,6046,6356
29015,Benton County,MO,19107,9508,9599,99.1,827,919,959,940,679,1569,1598,2459,1601,1763,3428,1806,559,53.6,3330,15777,7789,7988,97.5,18354,48,16,15679,7743,7936
29017,Bollinger County,MO,12225,6068,6157,98.6,636,762,770,748,591,1301,1397,1692,972,960,1406,770,220,44.0,2663,9562,4708,4854,97.0,11872,50,44,9546,4702,4844
29019,Boone County,MO,177651,86335,91316,94.5,10406,9722,10239,14494,25777,27191,20845,18704,9890,9303,12672,6088,2320,31.2,36059,141592,67628,73964,91.4,144228,15952,7880,134678,64004,70674
29021,Buchanan County,MO,88460,44631,43829,101.8,5666,5294,5825,5518,5768,12732,10921,11102,5939,5681,8001,4255,1758,37.8,20047,68413,34433,33980,101.3,77199,4588,962,66356,33358,32998
29023,Butler County,MO,42656,20865,21791,95.8,2633,2931,2686,2734,2395,5181,4714,5621,2798,3061,4472,2537,893,41.3,10039,32617,15648,16969,92.2,38560,2367,325,32315,15465,16850
29025,Caldwell County,MO,9039,4583,4456,102.9,534,546,672,632,476,901,1055,1174,682,618,981,536,232,42.3,2155,6884,3445,3439,100.2,8653,52,37,6826,3395,3431
29027,Callaway County,MO,44889,22886,22003,104.0,2464,2584,2735,3135,3297,5856,5455,6137,3147,2967,4335,2158,619,38.6,9514,35375,18089,17286,104.6,41309,1969,366,35142,17983,17159
29029,Camden County,MO,45466,22422,23044,97.3,1947,2024,2500,2617,1982,4083,4030,5560,4435,3706,7910,3464,1208,51.5,8209,37257,18199,19058,95.5,43778,364,139,36745,17978,18767
29031,Cape Girardeau County,MO,78491,37976,40515,93.7,4521,5201,4335,5720,8272,9838,8844,9085,5278,4684,7026,3748,1939,36.5,16810,61681,29496,32185,91.6,68877,5788,1348,60177,28790,31387
29033,Carroll County,MO,8781,4334,4447,97.5,533,533,592,511,456,930,992,1129,600,629,1061,582,233,43.4,1994,6787,3283,3504,93.7,8394,163,43,6735,3242,3493
29035,Carter County,MO,6147,3032,3115,97.3,378,326,440,451,324,618,696,784,465,458,726,435,46,41.7,1468,4679,2288,2391,95.7,5964,4,0,4679,2288,2391
29037,Cass County,MO,103597,50618,52979,95.5,6118,7623,6887,7010,5468,12295,13132,13731,7421,6810,9675,5376,2051,39.8,25214,78383,37603,40780,92.2,94521,4238,796,77462,37041,40421
29039,Cedar County,MO,14043,7041,7002,100.6,924,909,947,896,632,1401,1379,1664,1258,757,1826,1133,317,44.7,3390,10653,5261,5392,97.6,13507,7,30,10564,5228,5336
29041,Chariton County,MO,7483,3722,3761,99.0,488,416,488,424,403,712,758,860,650,507,871,604,302,45.7,1707,5776,2823,2953,95.6,7142,191,0,5769,2821,2948
29043,Christian County,MO,85658,41886,43772,95.7,5417,6607,6023,5696,4644,11101,11548,10834,5469,5279,7841,3936,1263,37.9,21879,63779,30693,33086,92.8,81611,707,484,62900,30263,32637
29045,Clark County,MO,6779,3435,3344,102.7,399,495,390,381,322,688,773,898,527,509,771,498,128,44.0,1547,5232,2625,2607,100.7,6598,21,69,5217,2625,2592
29047,Clay County,MO,242516,118973,123543,96.3,15801,16910,16259,15310,14656,34653,33411,32083,15564,14332,20159,9217,4161,37.1,58939,183577,88770,94807,93.6,206471,14884,5332,179546,86961,92585
29049,Clinton County,MO,20500,10149,10351,98.0,1096,1358,1445,1469,1009,2230,2500,2812,1660,1338,2019,1200,364,41.0,4936,15564,7618,7946,95.9,19612,310,136,15470,7586,7884
29051,Cole County,MO,76723,38674,38049,101.6,4592,4703,4991,5145,4614,10318,9783,10158,4981,5132,7255,3643,1408,38.6,17244,59479,30094,29385,102.4,64416,8985,1194,58225,29471,28754
29053,Cooper County,MO,17660,9280,8380,110.7,977,1033,1173,1108,1161,2507,2083,2147,1251,1183,1669,947,421,38.7,3832,13828,7315,6513,112.3,15675,1029,80,13743,7245,6498
29055,Crawford County,MO,24154,11920,12234,97.4,1371,1518,1652,1521,1315,2715,2748,3103,1993,1585,2677,1487,469,41.9,5559,18595,9123,9472,96.3,23350,90,51,18493,9085,9408
29057,Dade County,MO,7578,3846,3732,103.1,362,436,472,480,369,712,822,940,678,548,996,550,213,46.2,1573,6005,2981,3024,98.6,7234,27,64,5979,2973,3006
29059,Dallas County,MO,16617,8109,8508,95.3,1048,1168,1062,1116,699,1794,1762,2057,1088,1416,1948,997,462,44.0,3924,12693,6119,6574,93.1,15991,13,91,12534,6106,6428
29061,Daviess County,MO,8295,4170,4125,101.1,551,549,646,579,443,837,885,981,552,576,1018,493,185,41.1,2131,6164,3068,3096,99.1,8055,50,15,6145,3062,3083
29063,DeKalb County,MO,12526,7855,4671,168.2,571,577,579,580,842,1981,1940,1614,911,848,1072,730,281,40.4,2090,10436,6758,3678,183.7,10757,1122,75,10383,6716,3667
29065,Dent County,MO,15545,7771,7774,100.0,866,1176,825,951,710,1605,1686,1939,1469,979,1833,1110,396,44.7,3538,12007,5915,6092,97.1,14805,84,39,11982,5915,6067
29067,Douglas County,MO,13306,6648,6658,99.8,752,846,810,698,598,1314,1324,1616,1024,1143,1813,988,380,47.3,2893,10413,5154,5259,98.0,13079,30,11,10382,5139,5243
29069,Dunklin County,MO,30027,14368,15659,91.8,2067,1979,2329,2131,1570,3266,3452,3880,2084,1912,2917,1904,536,40.0,7685,22342,10375,11967,86.7,25396,3068,177,21637,10109,11528
29071,Franklin County,MO,103191,51467,51724,99.5,6226,6501,6784,6408,5828,12674,11639,14263,8590,6863,10154,5447,1814,40.7,23791,79400,38973,40427,96.4,99053,745,511,78980,38822,40158
29073,Gasconade County,MO,14711,7388,7323,100.9,745,755,992,774,780,1553,1477,1930,1107,1313,1776,1129,380,46.2,3043,11668,5741,5927,96.9,14300,79,50,11654,5734,5920
29075,Gentry County,MO,6616,3199,3417,93.6,465,477,441,394,352,783,678,795,567,367,608,451,238,40.4,1639,4977,2412,2565,94.0,6442,39,36,4927,2376,2551
29077,Greene County,MO,289756,140944,148812,94.7,17416,16550,16895,18934,30636,40796,33920,33340,17356,17250,25895,14547,6221,36.0,60505,229251,109980,119271,92.2,260411,9558,5930,225112,108156,116956
29079,Grundy County,MO,9992,4902,5090,96.3,715,590,621,701,601,1221,907,1136,649,679,1111,666,395,40.8,2328,7664,3749,3915,95.8,9591,28,64,7429,3577,3852
29081,Harrison County,MO,8491,4215,4276,98.6,570,613,558,512,384,879,929,924,578,648,962,665,269,43.3,2083,6408,3129,3279,95.4,8174,46,17,6338,3081,3257
29083,Henry County,MO,21735,10708,11027,97.1,1251,1263,1464,1219,994,2496,2402,2755,1562,1683,2614,1605,427,44.1,4804,16931,8308,8623,96.3,20743,273,107,16742,8236,8506
29085,Hickory County,MO,9404,4623,4781,96.7,405,401,489,479,284,750,746,1156,598,944,1848,1030,274,55.0,1600,7804,3841,3963,96.9,9044,3,25,7804,3841,3963
29087,Holt County,MO,4432,2187,2245,97.4,220,258,282,210,181,423,442,614,365,332,575,349,181,48.5,903,3529,1733,1796,96.5,4289,47,29,3521,1733,1788
29089,Howard County,MO,10058,5096,4962,102.7,591,676,575,776,888,1068,993,1214,685,735,1026,611,220,39.1,2216,7842,3906,3936,99.2,9214,598,36,7817,3897,3920
29091,Howell County,MO,40104,19571,20533,95.3,2583,2683,2626,2504,2365,4653,4509,5006,3090,2234,4444,2342,1065,40.9,9600,30504,14666,15838,92.6,38584,90,262,30279,14570,15709
29093,Iron County,MO,10164,5004,5160,97.0,532,484,695,594,500,1005,1183,1351,852,738,1299,646,285,45.7,2113,8051,3896,4155,93.8,9713,113,27,8041,3893,4148
29095,Jackson County,MO,696216,336640,359576,93.6,46348,45742,46251,41914,42651,107785,87114,86454,47743,42296,58963,30109,12846,36.8,165044,531172,252897,278275,90.9,466132,162382,12821,509771,242170,267601
29097,Jasper County,MO,119920,58563,61357,95.4,8110,8248,8699,8041,7988,16802,15093,14144,7981,6606,10315,5848,2045,36.2,30065,89855,43249,46606,92.8,108371,2283,1364,86600,41574,45026
29099,Jefferson County,MO,223951,111162,112789,98.6,13255,15061,15093,13748,12272,28461,29735,31286,17364,15186,20312,9277,2901,39.2,52412,171539,84407,87132,96.9,215137,2119,1817,170015,83733,86282
29101,Johnson County,MO,53682,27503,26179,105.1,3416,3030,3288,4384,8037,7737,5807,5517,3433,2452,3815,1898,868,30.5,11552,42130,21574,20556,105.0,47758,2326,917,41308,21182,20126
29103,Knox County,MO,3947,1977,1970,100.4,245,245,246,338,199,377,370,495,253,332,456,277,114,44.1,943,3004,1478,1526,96.9,3804,18,24,2974,1472,1502
29105,Laclede County,MO,35531,17431,18100,96.3,2367,2196,2682,2152,1928,4144,4295,4837,2440,2269,3588,2063,570,40.3,8692,26839,12953,13886,93.3,33751,205,131,26732,12930,13802
29107,Lafayette County,MO,32597,16270,16327,99.7,1781,2099,2198,2111,1723,3765,3583,4571,2339,2416,3205,2143,663,42.3,7507,25090,12298,12792,96.1,30578,717,174,24951,12198,12753
29109,Lawrence County,MO,38204,18918,19286,98.1,2571,2663,2733,2649,2115,4257,4395,4866,2508,2629,3681,2143,994,39.4,9691,28513,14066,14447,97.4,36225,184,14,27575,13565,14010
29111,Lewis County,MO,9955,5044,4911,102.7,568,483,806,1011,585,1057,1055,1216,724,620,1005,548,277,40.6,2235,7720,3851,3869,99.5,9255,419,0,7677,3816,3861
29113,Lincoln County,MO,56477,28056,28421,98.7,3764,4296,3727,3962,3318,7436,7109,7715,4077,3574,4495,2043,961,37.1,14419,42058,20667,21391,96.6,53593,1088,158,41853,20528,21325
29115,Linn County,MO,12113,5885,6228,94.5,727,762,891,748,702,1271,1295,1420,865,945,1370,833,284,41.8,2876,9237,4427,4810,92.0,11739,57,43,9219,4423,4796
29117,Livingston County,MO,15126,6740,8386,80.4,907,913,962,795,836,2140,1913,1785,892,978,1569,935,501,40.0,3318,11808,5037,6771,74.4,14146,388,94,11740,5003,6737
29119,McDonald County,MO,22782,11656,11126,104.8,1593,1509,1651,1623,1363,2714,2819,3008,1330,1692,2090,969,421,37.8,5782,17000,8509,8491,100.2,19833,415,343,15609,7803,7806
29121,Macon County,MO,15199,7633,7566,100.9,894,1117,1002,918,778,1556,1582,1877,882,1250,1782,1029,532,43.3,3607,11592,5714,5878,97.2,14346,297,94,11532,5687,5845
29123,Madison County,MO,12179,5948,6231,95.5,666,756,809,775,625,1497,1410,1590,791,974,1270,730,286,42.2,2783,9396,4500,4896,91.9,11798,92,69,9369,4481,4888
29125,Maries County,MO,8803,4447,4356,102.1,410,554,462,603,391,878,980,1200,873,577,1040,560,275,46.0,1773,7030,3551,3479,102.1,8513,26,91,6976,3538,3438
29127,Marion County,MO,28608,13856,14752,93.9,1783,1808,2021,2002,1766,3420,3342,3603,2014,1876,2737,1541,695,38.9,6824,21784,10464,11320,92.4,26193,1070,185,21670,10397,11273
29129,Mercer County,MO,3644,1817,1827,99.5,240,254,221,362,145,288,369,427,276,292,385,196,189,42.9,888,2756,1359,1397,97.3,3548,20,17,2728,1350,1378
29131,Miller County,MO,25201,12466,12735,97.9,1657,1704,1604,1549,1429,2915,2806,3290,1855,1649,2784,1298,661,40.7,5991,19210,9457,9753,97.0,24372,63,121,19016,9357,9659
29133,Mississippi County,MO,13574,7427,6147,120.8,624,849,917,751,699,2013,1729,1928,1014,662,1388,763,237,41.4,2858,10716,5847,4869,120.1,9913,3377,9,10598,5767,4831
29135,Moniteau County,MO,16046,8517,7529,113.1,1058,1058,1179,1034,871,2156,2143,2123,887,1036,1395,783,323,38.0,3952,12094,6557,5537,118.4,15403,438,9,12035,6513,5522
29137,Monroe County,MO,8629,4376,4253,102.9,462,446,571,541,411,842,913,1050,568,858,1099,653,215,46.5,1849,6780,3379,3401,99.4,8156,293,41,6752,3373,3379
29139,Montgomery County,MO,11487,5724,5763,99.3,707,701,718,644,536,1215,1307,1480,877,954,1239,836,273,44.5,2563,8924,4354,4570,95.3,10893,171,29,8869,4354,4515
29141,Morgan County,MO,20271,9959,10312,96.6,1320,1249,1217,1234,937,2023,1987,2474,1776,1318,2746,1378,612,46.0,4633,15638,7705,7933,97.1,19448,178,182,15581,7695,7886
29143,New Madrid County,MO,17560,8388,9172,91.5,1106,1202,1218,1026,899,1975,2059,2275,1346,1199,1900,938,417,42.0,4103,13457,6336,7121,89.0,14313,2703,0,13390,6299,7091
29145,Newton County,MO,58180,28812,29368,98.1,3605,3333,4600,3856,3459,6883,6655,7535,4276,3656,5968,3212,1142,39.9,13977,44203,21591,22612,95.5,52559,549,831,43211,21030,22181
29147,Nodaway County,MO,22359,11102,11257,98.6,1025,928,975,2523,4436,2471,2156,2143,1164,1222,1724,1163,429,29.7,3571,18788,9297,9491,98.0,20946,617,306,18412,9090,9322
29149,Oregon County,MO,10647,5268,5379,97.9,631,674,703,675,451,1007,1075,1362,796,808,1369,844,252,46.4,2421,8226,4024,4202,95.8,10157,16,51,8200,4007,4193
29151,Osage County,MO,13615,7034,6581,106.9,790,758,1045,935,813,1530,1592,1888,1017,908,1270,706,363,40.8,3145,10470,5415,5055,107.1,13497,24,4,10466,5411,5055
29153,Ozark County,MO,9207,4489,4718,95.1,395,636,424,502,377,742,855,1096,880,779,1444,896,181,51.6,1828,7379,3618,3761,96.2,8838,6,47,7361,3616,3745
29155,Pemiscot County,MO,16663,7817,8846,88.4,1238,1125,1235,1113,1090,1913,1875,2069,1308,940,1538,863,356,37.9,4335,12328,5583,6745,82.8,11587,4587,0,12251,5543,6708
29157,Perry County,MO,19191,9499,9692,98.0,1118,1368,1272,1185,1084,2201,2272,2478,1468,1259,1897,1112,477,40.7,4550,14641,7161,7480,95.7,18632,108,230,14510,7080,7430
29159,Pettis County,MO,42355,21063,21292,98.9,2913,2701,3176,2720,2662,5462,4983,5175,2827,2793,3855,2081,1007,37.8,10524,31831,15475,16356,94.6,38705,1483,279,30299,14704,15595
29161,Phelps County,MO,44630,23373,21257,110.0,2518,2751,2603,3951,5046,5273,4681,5026,3297,2445,3877,2308,854,35.3,9410,35220,18489,16731,110.5,40391,1079,1620,33721,17486,16235
29163,Pike County,MO,18455,10117,8338,121.3,1077,1252,1012,1055,1250,2585,2205,2408,1141,1329,1786,996,359,38.9,4042,14413,8027,6386,125.7,16421,1338,64,14349,7980,6369
29165,Platte County,MO,100682,49730,50952,97.6,6117,6860,6783,6359,6116,13413,13852,13790,6934,6075,8868,4039,1476,38.2,23949,76733,37562,39171,95.9,85900,6825,2757,74475,36450,38025
29167,Polk County,MO,31748,15532,16216,95.8,1939,1889,2037,2762,2771,3361,3513,3799,2221,1789,3116,1916,635,37.6,7338,24410,11832,12578,94.1,30348,294,78,24318,11773,12545
29169,Pulaski County,MO,52425,29924,22501,133.0,3442,3099,3303,6524,7125,9353,6037,4898,2104,2165,2586,1144,645,27.6,11522,40903,23749,17154,138.4,39671,5879,1316,39492,23077,16415
29171,Putnam County,MO,4781,2403,2378,101.1,318,315,290,308,218,456,452,585,345,349,610,406,129,45.8,1112,3669,1807,1862,97.0,4611,5,6,3658,1807,1851
29173,Ralls County,MO,10234,5196,5038,103.1,524,596,680,619,534,975,1184,1375,766,840,1316,680,145,45.0,2182,8052,4067,3985,102.1,9860,135,59,8021,4045,3976
29175,Randolph County,MO,24878,12987,11891,109.2,1471,1725,1309,1525,1666,3335,3140,3417,1525,1680,2298,1302,485,39.4,5451,19427,10165,9262,109.7,22388,1463,158,19350,10131,9219
29177,Ray County,MO,22875,11276,11599,97.2,1322,1218,1719,1437,1318,2541,2621,3147,1654,1790,2355,1338,415,42.2,5216,17659,8702,8957,97.2,21924,308,44,17611,8664,8947
29179,Reynolds County,MO,6290,3290,3000,109.7,264,362,327,427,287,619,752,806,537,484,795,458,172,46.5,1249,5041,2589,2452,105.6,5939,128,19,5034,2586,2448
29181,Ripley County,MO,13567,6749,6818,99.0,849,1002,739,788,666,1575,1546,1657,966,987,1595,948,249,42.3,3116,10451,5136,5315,96.6,13092,94,54,10430,5136,5294
29183,St. Charles County,MO,394290,193719,200571,96.6,23517,25894,27153,25803,24125,51121,52733,53071,28508,24331,34254,17415,6365,38.6,92951,301339,146416,154923,94.5,353297,17468,10183,293908,142717,151191
29185,St. Clair County,MO,9370,4655,4715,98.7,480,376,642,486,419,862,855,1145,837,722,1375,877,294,50.3,1828,7542,3764,3778,99.6,8955,68,36,7519,3741,3778
29186,Ste. Genevieve County,MO,17848,9050,8798,102.9,889,1079,1144,1139,934,1920,2021,2373,1394,1570,1947,1018,420,43.3,3883,13965,7071,6894,102.6,17257,350,102,13898,7013,6885
29187,St. Francois County,MO,66643,35826,30817,116.3,3591,3542,4377,3824,4111,9832,8962,8828,4792,3988,6167,3509,1120,39.4,13996,52647,28730,23917,120.1,61886,2960,344,52322,28553,23769
29189,St. Louis County,MO,996919,472970,523949,90.3,58550,59176,63312,63400,62170,127125,118220,127824,72028,68964,98048,51272,26830,40.3,220364,776555,360637,415918,86.7,677308,240884,42911,746534,344897,401637
29195,Saline County,MO,22976,11569,11407,101.4,1439,1546,1449,1797,1671,2631,2785,2531,1709,1274,2272,1171,701,37.9,5311,17665,8835,8830,100.1,19851,1150,187,16767,8319,8448
29197,Schuyler County,MO,4555,2237,2318,96.5,354,354,281,354,212,509,462,540,368,244,466,329,82,40.1,1197,3358,1639,1719,95.3,4419,21,12,3352,1636,1716
29199,Scotland County,MO,4902,2426,2476,98.0,408,474,307,353,276,546,514,538,307,281,466,254,178,37.3,1414,3488,1706,1782,95.7,4866,0,0,3488,1706,1782
29201,Scott County,MO,38633,18685,19948,93.7,2486,2902,2352,2164,2424,4738,4405,5036,2800,2441,3959,2086,840,40.0,9213,29420,13916,15504,89.8,32934,4494,160,29176,13809,15367
29203,Shannon County,MO,8217,4016,4201,95.6,458,591,443,497,372,944,766,1053,649,718,1002,567,157,45.8,1803,6414,3110,3304,94.1,7862,14,0,6411,3107,3304
29205,Shelby County,MO,6013,3025,2988,101.2,347,457,390,374,314,617,677,678,499,424,672,399,165,42.3,1455,4558,2241,2317,96.7,5765,97,16,4545,2235,2310
29207,Stoddard County,MO,29377,14277,15100,94.5,1694,1785,1882,1862,1612,3492,3469,3811,2122,1872,3138,2004,634,41.4,6566,22811,10957,11854,92.4,28474,437,3,22739,10924,11815
29209,Stone County,MO,31615,15430,16185,95.3,1233,1143,1823,1624,1357,2465,2962,3765,2739,2913,5855,2689,1047,53.6,5275,26340,12782,13558,94.3,30437,64,74,26144,12667,13477
29211,Sullivan County,MO,6247,3073,3174,96.8,391,329,442,360,363,641,782,826,503,358,709,332,211,42.1,1393,4854,2361,2493,94.7,5658,142,6,4605,2239,2366
29213,Taney County,MO,55114,26630,28484,93.5,3108,3237,3282,3722,3785,6166,6001,6717,3672,3695,6917,3481,1331,42.2,11708,43406,20697,22709,91.1,50517,839,546,42224,20141,22083
29215,Texas County,MO,25604,13364,12240,109.2,1400,1762,1396,1416,1288,2871,3038,3278,1942,1964,2903,1736,610,43.2,5535,20069,10488,9581,109.5,23769,559,190,20018,10458,9560
29217,Vernon County,MO,20595,10066,10529,95.6,1279,1448,1310,1600,1261,2181,2246,2568,1294,1549,2154,1284,421,40.8,4994,15601,7416,8185,90.6,19685,111,148,15497,7392,8105
29219,Warren County,MO,34453,17144,17309,99.0,2221,2114,2542,2042,1911,4011,3952,4498,2713,2379,3590,2087,393,41.0,8213,26240,12951,13289,97.5,31950,700,213,26124,12912,13212
29221,Washington County,MO,24860,12778,12082,105.8,1448,1540,1627,1551,1365,3040,3013,3601,1841,1799,2446,1280,309,40.8,5671,19189,9963,9226,108.0,23681,529,53,19141,9963,9178
29223,Wayne County,MO,13195,6442,6753,95.4,666,673,958,801,567,1302,1275,1797,1083,1024,1733,956,360,47.5,2831,10364,5085,5279,96.3,12747,73,36,10332,5064,5268
29225,Webster County,MO,38655,19784,18871,104.8,2863,3120,2716,2685,2143,4574,4659,5114,2368,2419,3457,1887,650,36.7,10437,28218,14274,13944,102.4,36918,392,148,28101,14234,13867
29227,Worth County,MO,2027,976,1051,92.9,112,123,93,130,94,204,197,241,174,159,233,144,123,48.1,410,1617,778,839,92.7,1982,11,3,1617,778,839
29229,Wright County,MO,18203,8910,9293,95.9,1294,1259,1264,1226,882,1896,1934,2224,1397,1290,1952,1226,359,41.7,4634,13569,6555,7014,93.5,17593,97,45,13518,6540,6978
29510,St. Louis city,MO,308174,149175,158999,93.8,19673,15286,16211,15891,21841,61349,40386,36559,20224,20278,24252,11276,4948,35.8,59819,248355,118532,129823,91.3,143401,143018,10365,237461,112561,124900
30001,Beaverhead County,MT,9415,4682,4733,98.9,452,470,410,836,843,923,965,953,735,818,1108,679,223,43.0,1654,7761,3854,3907,98.6,8922,7,59,7622,3767,3855
30003,Big Horn County,MT,13387,6680,6707,99.6,1158,1434,1251,1142,801,1577,1391,1507,659,842,1024,452,149,30.7,4541,8846,4236,4610,91.9,4009,4,12,8745,4162,4583
30005,Blaine County,MT,6719,3350,3369,99.4,568,599,535,524,363,846,734,701,509,327,599,270,144,33.8,2007,4712,2274,2438,93.3,3026,27,7,4709,2274,2435
30007,Broadwater County,MT,5945,3035,2910,104.3,272,261,384,407,333,453,621,829,435,558,860,426,106,47.3,1157,4788,2449,2339,104.7,5736,5,0,4749,2436,2313
30009,Carbon County,MT,10597,5372,5225,102.8,377,525,596,614,362,920,1210,1410,961,974,1649,636,363,50.5,1878,8719,4384,4335,101.1,10240,43,30,8695,4366,4329
30011,Carter County,MT,1331,683,648,105.4,82,127,52,33,72,137,123,153,134,117,146,119,36,47.8,287,1044,530,514,103.1,1290,0,0,1044,530,514
30013,Cascade County,MT,81625,41235,40390,102.1,5495,5066,5074,4461,6174,11354,9029,9105,5360,5557,8371,4434,2145,38.3,18345,63280,31687,31593,100.3,71577,1080,595,62770,31484,31286
30015,Chouteau County,MT,5732,2819,2913,96.8,315,458,350,329,351,659,591,641,370,522,669,308,169,41.9,1356,4376,2197,2179,100.8,4456,14,36,4321,2177,2144
30017,Custer County,MT,11729,5850,5879,99.5,668,712,706,775,632,1458,1317,1405,917,896,1215,731,297,41.4,2575,9154,4473,4681,95.6,10990,74,11,9136,4468,4668
30019,Daniels County,MT,1730,925,805,114.9,87,81,137,97,45,111,247,196,194,112,173,150,100,49.2,394,1336,676,660,102.4,1655,0,14,1329,676,653
30021,Dawson County,MT,9017,4759,4258,111.8,575,572,442,632,475,1155,1082,1006,735,669,911,641,122,41.0,1912,7105,3762,3343,112.5,8522,70,22,7029,3744,3285
30023,Deer Lodge County,MT,9106,4796,4310,111.3,343,343,398,644,456,869,1164,1196,723,895,1241,656,178,48.6,1450,7656,4010,3646,110.0,8459,68,69,7590,3989,3601
30025,Fallon County,MT,2921,1467,1454,100.9,180,228,217,160,142,376,359,307,111,320,266,150,105,39.3,727,2194,1131,1063,106.4,2785,1,51,2123,1117,1006
30027,Fergus County,MT,11221,5742,5479,104.8,705,537,726,585,477,1305,1242,1287,886,866,1458,754,393,45.3,2346,8875,4440,4435,100.1,10602,15,66,8778,4373,4405
30029,Flathead County,MT,99899,49898,50001,99.8,5698,5966,6610,5796,5087,11718,12429,12105,7030,8777,11658,5302,1723,42.2,22022,77877,38421,39456,97.4,93989,440,698,77063,38099,38964
30031,Gallatin County,MT,108063,56112,51951,108.0,6144,6002,6197,7388,13337,17389,14686,11429,6074,6202,8399,3665,1151,33.4,21648,86415,45018,41397,108.7,101395,426,1472,84788,44190,40598
30033,Garfield County,MT,1036,552,484,114.0,69,60,36,73,65,96,112,114,85,87,138,75,26,45.8,212,824,405,419,96.7,1029,7,0,824,405,419
30035,Glacier County,MT,13732,6767,6965,97.2,1257,1091,1409,926,907,1894,1537,1411,943,736,967,470,184,31.9,4336,9396,4604,4792,96.1,4381,39,6,9300,4564,4736
30037,Golden Valley County,MT,728,370,358,103.4,23,30,38,26,26,43,44,96,82,135,110,50,25,56.9,105,623,312,311,100.3,688,10,0,623,312,311
30039,Granite County,MT,3311,1708,1603,106.6,123,156,199,296,83,165,324,366,282,352,578,274,113,54.3,625,2686,1391,1295,107.4,3188,3,2,2679,1389,1290
30041,Hill County,MT,16436,8307,8129,102.2,1452,1301,1126,1163,1181,2187,1781,1680,1199,975,1404,739,248,34.3,4546,11890,5982,5908,101.3,11544,68,71,11805,5961,5844
30043,Jefferson County,MT,11917,6027,5890,102.3,469,544,857,860,548,1004,1248,1718,920,1301,1696,563,189,47.6,2512,9405,4793,4612,103.9,11220,45,6,9352,4779,4573
30045,Judith Basin County,MT,1954,1064,890,119.6,94,68,120,138,51,159,216,229,219,217,285,125,33,51.7,399,1555,840,715,117.5,1856,0,0,1553,840,713
30047,Lake County,MT,30013,14899,15114,98.6,1844,2090,1994,1947,1516,3166,3098,3363,2179,2393,3860,2075,488,42.3,7159,22854,11151,11703,95.3,20103,89,100,22571,11019,11552
30049,Lewis and Clark County,MT,67805,33580,34225,98.1,3848,4185,4161,4204,3698,8429,8186,8419,5305,5177,7649,3067,1477,40.8,14615,53190,26097,27093,96.3,63568,183,464,52860,25957,26903
30051,Liberty County,MT,2351,1115,1236,90.2,115,162,145,142,50,271,251,254,150,221,284,162,144,46.5,533,1818,832,986,84.4,2340,0,0,1818,832,986
30053,Lincoln County,MT,19537,9711,9826,98.8,841,1130,826,1048,667,1577,1833,2471,1661,2065,3380,1539,499,52.4,3558,15979,7930,8049,98.5,18511,40,79,15791,7928,7863
30055,McCone County,MT,1790,902,888,101.6,117,173,84,80,107,194,133,188,161,104,219,149,81,46.6,421,1369,701,668,104.9,1653,0,29,1359,696,663
30057,Madison County,MT,8302,4294,4008,107.1,320,429,301,344,331,943,778,926,626,902,1573,540,289,53.0,1273,7029,3684,3345,110.1,7889,16,3,6773,3527,3246
30059,Meagher County,MT,1888,974,914,106.6,152,79,113,93,115,180,189,190,185,139,262,111,80,48.0,363,1525,805,720,111.8,1749,1,3,1491,793,698
30061,Mineral County,MT,4251,2177,2074,105.0,186,218,209,246,193,374,367,507,388,370,720,392,81,51.7,784,3467,1803,1664,108.4,3942,34,36,3458,1795,1663
30063,Missoula County,MT,117309,58730,58579,100.3,5815,6025,6795,7579,12143,18504,15153,13135,7667,6840,11022,4943,1688,36.0,22265,95044,47357,47687,99.3,107417,751,2174,93474,46555,46919
30065,Musselshell County,MT,4766,2379,2387,99.7,191,275,267,318,174,350,498,617,429,412,761,380,94,50.1,946,3820,1897,1923,98.6,4484,0,43,3805,1888,1917
30067,Park County,MT,16352,8141,8211,99.1,763,699,885,732,762,2011,1986,2149,1413,1386,2209,924,433,46.3,2879,13473,6638,6835,97.1,15631,73,51,13283,6562,6721
30069,Petroleum County,MT,453,235,218,107.8,34,10,37,21,1,51,37,65,44,52,31,60,10,51.8,91,362,174,188,92.6,428,0,25,362,174,188
30071,Phillips County,MT,4077,2089,1988,105.1,279,292,235,258,131,362,420,499,318,372,478,345,88,49.0,952,3125,1538,1587,96.9,3442,0,12,3104,1523,1581
30073,Pondera County,MT,5994,2974,3020,98.5,431,387,410,473,231,676,600,682,435,471,630,350,218,40.7,1471,4523,2226,2297,96.9,4881,8,6,4487,2220,2267
30075,Powder River County,MT,1607,811,796,101.9,106,16,80,73,118,146,122,184,130,192,243,127,70,53.4,261,1346,667,679,98.2,1515,0,0,1329,654,675
30077,Powell County,MT,6854,4294,2560,167.7,251,256,325,371,352,888,933,1050,565,492,806,467,98,45.5,1030,5824,3818,2006,190.3,6187,64,26,5805,3806,1999
30079,Prairie County,MT,1252,643,609,105.6,53,79,112,62,24,48,187,115,133,89,235,72,43,48.7,285,967,511,456,112.1,1224,0,10,943,501,442
30081,Ravalli County,MT,42512,21114,21398,98.7,1918,2150,2486,2541,1864,3639,4598,5468,3281,3893,6555,3169,950,49.1,8225,34287,16778,17509,95.8,40736,55,226,34022,16685,17337
30083,Richland County,MT,11199,5709,5490,104.0,686,720,929,842,591,1432,1429,1310,724,888,1031,364,253,38.6,2833,8366,4302,4064,105.9,10445,0,3,8209,4200,4009
30085,Roosevelt County,MT,11175,5502,5673,97.0,1020,1018,1149,839,706,1546,1220,1111,687,639,740,368,132,30.2,3746,7429,3661,3768,97.2,4029,24,67,7352,3622,3730
30087,Rosebud County,MT,9152,4567,4585,99.6,667,611,858,702,555,981,960,1070,583,811,895,366,93,36.8,2615,6537,3264,3273,99.7,5218,16,95,6415,3221,3194
30089,Sanders County,MT,11681,5995,5686,105.4,543,575,586,618,430,856,1083,1274,1089,1121,2182,1126,198,53.9,2081,9600,4887,4713,103.7,10803,36,49,9497,4870,4627
30091,Sheridan County,MT,3483,1747,1736,100.6,232,255,144,124,202,435,317,402,222,343,448,223,136,46.3,708,2775,1364,1411,96.7,3292,0,9,2730,1349,1381
30093,Silver Bow County,MT,34770,17613,17157,102.7,2048,2011,1844,1998,3131,3975,3969,4232,2444,2599,3790,2081,648,40.0,7017,27753,13899,13854,100.3,32807,191,263,27204,13520,13684
30095,Stillwater County,MT,9466,4713,4753,99.2,430,538,694,662,381,798,1016,1191,831,846,1315,585,179,46.8,2106,7360,3711,3649,101.7,9075,8,32,7319,3692,3627
30097,Sweet Grass County,MT,3670,1840,1830,100.5,162,160,241,158,224,317,314,424,195,365,582,397,131,52.0,694,2976,1468,1508,97.3,3534,0,10,2955,1468,1487
30099,Teton County,MT,6086,2973,3113,95.5,399,430,401,378,308,567,613,729,488,393,728,486,166,44.4,1468,4618,2269,2349,96.6,5746,33,16,4597,2266,2331
30101,Toole County,MT,4892,2720,2172,125.2,261,292,154,274,325,607,617,626,437,474,453,242,130,43.1,931,3961,2280,1681,135.6,4376,23,32,3934,2264,1670
30103,Treasure County,MT,668,328,340,96.5,35,27,22,35,29,51,38,79,56,104,131,51,10,56.8,106,562,275,287,95.8,632,0,28,562,275,287
30105,Valley County,MT,7471,3700,3771,98.1,432,353,556,403,315,931,819,838,557,609,866,649,143,44.3,1646,5825,2840,2985,95.1,6429,29,16,5796,2824,2972
30107,Wheatland County,MT,2142,1032,1110,93.0,131,182,153,127,135,201,224,234,147,176,251,130,51,41.1,538,1604,755,849,88.9,2024,0,7,1555,711,844
30109,Wibaux County,MT,1122,524,598,87.6,115,63,81,43,43,94,76,182,74,101,141,59,50,47.1,301,821,381,440,86.6,1101,0,8,813,381,432
30111,Yellowstone County,MT,159008,78348,80660,97.1,10004,10695,10791,9302,9560,22006,19899,19085,10901,10490,15234,7354,3687,38.4,37451,121557,59221,62336,95.0,143434,1183,1110,120241,58571,61670
31001,Adams County,NE,31587,15846,15741,100.7,2009,2174,2088,2516,2242,3793,3295,3526,2155,2193,3059,1672,865,37.7,7511,24076,11935,12141,98.3,29380,203,405,23025,11401,11624
31003,Antelope County,NE,6341,3186,3155,101.0,410,413,419,366,336,612,621,704,396,609,735,447,273,44.9,1491,4850,2405,2445,98.4,6168,63,15,4767,2352,2415
31005,Arthur County,NE,427,203,224,90.6,15,48,41,17,20,31,38,49,37,24,50,50,7,45.5,119,308,145,163,89.0,411,0,0,306,144,162
31007,Banner County,NE,722,350,372,94.1,63,43,28,36,24,58,92,69,84,70,107,35,13,48.9,163,559,268,291,92.1,693,0,10,548,261,287
31009,Blaine County,NE,477,243,234,103.8,27,27,41,12,9,41,44,57,39,48,72,41,19,53.2,104,373,193,180,107.2,477,0,0,373,193,180
31011,Boone County,NE,5279,2611,2668,97.9,329,374,330,293,290,527,504,630,347,482,558,370,245,44.8,1228,4051,2004,2047,97.9,5195,17,29,4034,1990,2044
31013,Box Butte County,NE,10970,5505,5465,100.7,715,880,733,651,564,1235,1401,1075,754,1078,1079,553,252,39.4,2794,8176,4022,4154,96.8,10144,149,119,7832,3838,3994
31015,Boyd County,NE,1937,963,974,98.9,77,85,156,86,80,116,189,196,221,147,342,151,91,54.3,394,1543,772,771,100.1,1855,11,19,1524,765,759
31017,Brown County,NE,3015,1462,1553,94.1,154,207,165,111,140,275,316,340,230,263,398,318,98,49.4,600,2415,1174,1241,94.6,2935,1,14,2347,1136,1211
31019,Buffalo County,NE,49209,24601,24608,100.0,3351,3282,3072,3968,5330,6666,5939,5108,2664,2966,3911,2020,932,33.5,11549,37660,18524,19136,96.8,45150,492,643,36341,17825,18516
31021,Burt County,NE,6510,3177,3333,95.3,331,479,411,350,307,620,676,794,469,533,765,538,237,45.7,1462,5048,2401,2647,90.7,6180,31,51,4983,2376,2607
31023,Butler County,NE,8029,4003,4026,99.4,474,531,521,560,399,802,878,1006,652,564,860,523,259,43.3,1902,6127,3086,3041,101.5,7739,12,56,6055,3044,3011
31025,Cass County,NE,25888,13070,12818,102.0,1498,1880,1755,1659,1342,2643,3204,3593,2049,1869,2644,1273,479,41.7,6232,19656,9805,9851,99.5,24821,87,77,19529,9707,9822
31027,Cedar County,NE,8498,4327,4171,103.7,562,625,613,499,472,792,838,968,596,727,875,539,392,42.7,2156,6342,3165,3177,99.6,8279,13,5,6307,3146,3161
31029,Chase County,NE,3783,1833,1950,94.0,184,227,311,198,188,361,478,416,291,300,363,295,171,43.5,874,2909,1417,1492,95.0,3758,2,10,2679,1319,1360
31031,Cherry County,NE,5779,2940,2839,103.6,398,326,339,403,265,652,685,610,414,492,594,407,194,43.1,1342,4437,2246,2191,102.5,5168,1,28,4391,2229,2162
31033,Cheyenne County,NE,9604,4759,4845,98.2,650,624,598,597,467,1161,1158,1226,652,692,920,532,327,40.4,2256,7348,3679,3669,100.3,9112,80,66,7242,3604,3638
31035,Clay County,NE,6203,3159,3044,103.8,417,446,415,352,358,656,637,745,501,440,706,333,197,42.5,1535,4668,2367,2301,102.9,5995,13,5,4532,2304,2228
31037,Colfax County,NE,10714,5936,4778,124.2,952,807,946,662,672,1509,1341,1138,802,537,705,443,200,33.7,3191,7523,4094,3429,119.4,9512,401,79,5424,2715,2709
31039,Cuming County,NE,8952,4487,4465,100.5,556,515,747,556,512,903,855,1059,840,465,915,689,340,42.6,2202,6750,3428,3322,103.2,8432,9,27,6483,3229,3254
31041,Custer County,NE,10826,5377,5449,98.7,683,718,730,586,585,1188,1171,1232,881,684,1241,776,351,43.1,2551,8275,4113,4162,98.8,10474,17,82,8144,4032,4112
31043,Dakota County,NE,20173,10125,10048,100.8,1738,1414,1787,1320,1457,2851,2316,2337,1228,1019,1604,750,352,33.4,5867,14306,7049,7257,97.1,13877,1099,678,11750,5811,5939
31045,Dawes County,NE,8810,4266,4544,93.9,448,395,453,1195,1114,809,818,827,641,500,816,558,236,34.9,1576,7234,3468,3766,92.1,7932,385,59,7156,3436,3720
31047,Dawson County,NE,23733,12279,11454,107.2,2031,1690,1633,1665,1439,3112,2777,2638,1664,1388,2025,1054,617,35.7,6498,17235,8951,8284,108.1,20758,1504,149,14794,7475,7319
31049,Deuel County,NE,1831,875,956,91.5,105,92,119,70,92,207,162,239,144,171,220,140,70,48.7,359,1472,702,770,91.2,1747,3,11,1450,684,766
31051,Dixon County,NE,5719,2909,2810,103.5,398,388,392,350,324,590,635,665,399,436,638,341,163,40.8,1427,4292,2139,2153,99.3,5328,25,22,4022,1993,2029
31053,Dodge County,NE,36665,18022,18643,96.7,2479,2495,2383,2342,2401,4217,4266,4280,2442,2383,3638,2208,1131,38.9,8787,27878,13535,14343,94.4,34718,350,129,26159,12496,13663
31055,Douglas County,NE,560617,276459,284158,97.3,42259,40220,39013,37240,36772,87570,74310,66938,34295,31106,42389,19813,8692,34.7,144274,416343,202839,213504,95.0,443883,62004,21389,385199,186784,198415
31057,Dundy County,NE,1913,977,936,104.4,129,133,145,89,114,185,222,216,129,139,234,73,105,43.3,458,1455,725,730,99.3,1902,4,0,1341,668,673
31059,Fillmore County,NE,5547,2748,2799,98.2,270,294,306,330,281,608,561,711,487,419,652,391,237,47.0,1115,4432,2189,2243,97.6,5374,21,31,4414,2181,2233
31061,Franklin County,NE,2987,1473,1514,97.3,148,160,150,142,144,267,292,345,290,240,408,266,135,50.8,557,2430,1185,1245,95.2,2918,15,6,2424,1185,1239
31063,Frontier County,NE,2640,1349,1291,104.5,129,153,128,220,193,246,241,273,198,191,337,269,62,45.2,518,2122,1069,1053,101.5,2569,15,2,2106,1067,1039
31065,Furnas County,NE,4747,2347,2400,97.8,280,292,277,307,231,429,481,548,332,408,625,334,203,46.9,1058,3689,1817,1872,97.1,4589,6,14,3627,1779,1848
31067,Gage County,NE,21594,10854,10740,101.1,1247,1265,1538,1261,1071,2230,2512,2736,1583,1722,2207,1393,829,43.8,4883,16711,8239,8472,97.2,20839,130,143,16579,8189,8390
31069,Garden County,NE,1864,942,922,102.2,79,47,169,97,31,166,229,236,154,140,260,196,60,50.4,375,1489,753,736,102.3,1836,3,3,1442,719,723
31071,Garfield County,NE,2001,1005,996,100.9,89,108,118,105,112,210,155,177,126,230,275,212,84,50.9,397,1604,785,819,95.8,1958,7,4,1604,785,819
31073,Gosper County,NE,2013,1039,974,106.7,77,68,117,105,70,203,173,272,199,203,316,155,55,53.4,352,1661,796,865,92.0,1964,5,7,1635,783,852
31075,Grant County,NE,722,387,335,115.5,57,41,47,59,52,69,60,66,58,61,83,42,27,38.8,172,550,297,253,117.4,700,6,0,550,297,253
31077,Greeley County,NE,2382,1172,1210,96.9,151,128,182,151,110,219,232,260,139,208,276,204,122,45.5,560,1822,897,925,97.0,2322,10,4,1808,892,916
31079,Hall County,NE,61265,30884,30381,101.7,4704,4535,4913,4089,3729,7973,7572,7428,3925,3459,4903,2497,1538,35.9,16801,44464,22105,22359,98.9,51453,1691,672,39585,19366,20219
31081,Hamilton County,NE,9215,4575,4640,98.6,564,508,676,638,510,1004,981,1168,664,704,987,549,262,41.9,2184,7031,3436,3595,95.6,8856,17,33,7003,3435,3568
31083,Harlan County,NE,3415,1733,1682,103.0,206,231,242,189,195,275,357,369,217,289,428,277,140,45.3,827,2588,1343,1245,107.9,3289,18,7,2565,1340,1225
31085,Hayes County,NE,893,464,429,108.2,59,67,43,26,43,100,103,82,88,116,89,52,25,45.7,190,703,371,332,111.7,878,0,0,677,354,323
31087,Hitchcock County,NE,2815,1400,1415,98.9,162,177,193,189,82,253,312,303,197,235,371,247,94,46.2,644,2171,1062,1109,95.8,2802,2,0,2168,1062,1106
31089,Holt County,NE,10177,5128,5049,101.6,636,622,853,491,558,997,1074,1132,902,719,1131,652,410,42.8,2480,7697,3820,3877,98.5,9933,14,57,7586,3746,3840
31091,Hooker County,NE,693,324,369,87.8,25,21,40,46,50,41,59,87,52,46,76,107,43,53.3,115,578,289,289,100.0,677,7,0,578,289,289
31093,Howard County,NE,6417,3257,3160,103.1,390,428,496,373,265,663,742,791,437,478,734,405,215,43.1,1553,4864,2427,2437,99.6,6196,10,14,4822,2414,2408
31095,Jefferson County,NE,7144,3473,3671,94.6,399,496,387,413,299,700,732,831,474,727,878,527,281,46.5,1564,5580,2734,2846,96.1,6926,45,15,5530,2716,2814
31097,Johnson County,NE,5161,3071,2090,146.9,235,283,265,237,367,686,709,709,278,453,467,335,137,40.9,961,4200,2570,1630,157.7,4458,313,81,4067,2473,1594
31099,Kearney County,NE,6529,3236,3293,98.3,420,479,465,416,330,713,749,767,455,496,645,357,237,39.6,1636,4893,2412,2481,97.2,6314,7,32,4781,2330,2451
31101,Keith County,NE,8068,4130,3938,104.9,369,533,470,352,369,782,853,928,605,652,1174,752,229,49.3,1624,6444,3261,3183,102.5,7745,98,62,6348,3214,3134
31103,Keya Paha County,NE,760,366,394,92.9,40,29,57,95,32,36,87,79,78,44,87,78,18,45.3,199,561,281,280,100.4,749,0,0,561,281,280
31105,Kimball County,NE,3633,1816,1817,99.9,141,211,292,174,146,374,404,435,229,334,477,324,92,46.3,781,2852,1424,1428,99.7,3423,3,12,2796,1381,1415
31107,Knox County,NE,8426,4177,4249,98.3,542,514,626,430,477,771,804,906,656,639,1009,714,338,45.6,2034,6392,3147,3245,97.0,7316,34,27,6347,3113,3234
31109,Lancaster County,NE,313158,157231,155927,100.8,20085,19710,20577,23153,35397,43849,38710,33940,18322,17238,25124,11594,5459,33.5,71674,241484,120505,120979,99.6,269630,12501,13153,229669,114277,115392
31111,Lincoln County,NE,35263,17300,17963,96.3,2055,2352,2458,2300,1724,4137,4506,4081,2451,2538,3644,2035,982,41.1,8354,26909,13170,13739,95.9,33426,542,312,26474,12951,13523
31113,Logan County,NE,927,503,424,118.6,62,46,88,86,28,57,148,106,61,59,107,58,21,38.6,256,671,339,332,102.1,915,0,0,641,324,317
31115,Loup County,NE,605,313,292,107.2,39,22,12,22,48,90,24,58,66,76,96,45,7,53.2,93,512,262,250,104.8,603,0,0,512,262,250
31117,McPherson County,NE,395,204,191,106.8,12,15,24,17,4,28,24,77,39,37,62,37,19,54.8,61,334,162,172,94.2,389,0,0,333,161,172
31119,Madison County,NE,35080,17447,17633,98.9,2574,2229,2643,2384,2334,4565,4077,3948,2682,2192,2880,1582,990,36.6,8816,26264,13001,13263,98.0,32143,458,602,24837,12147,12690
31121,Merrick County,NE,7798,3916,3882,100.9,492,469,473,461,398,830,898,984,607,569,861,550,206,43.6,1737,6061,3052,3009,101.4,7410,37,40,5893,2985,2908
31123,Morrill County,NE,4781,2426,2355,103.0,290,363,290,318,156,596,527,581,289,409,495,330,137,42.3,1133,3648,1840,1808,101.8,4556,37,23,3495,1742,1753
31125,Nance County,NE,3544,1779,1765,100.8,198,258,187,223,152,366,391,430,360,256,358,219,146,44.8,783,2761,1354,1407,96.2,3504,14,0,2739,1354,1385
31127,Nemaha County,NE,6973,3486,3487,100.0,387,422,397,647,531,809,711,738,463,491,747,416,214,39.3,1466,5507,2735,2772,98.7,6684,105,53,5452,2720,2732
31129,Nuckolls County,NE,4244,2114,2130,99.2,223,234,281,237,198,374,409,437,330,390,551,421,159,49.2,887,3357,1657,1700,97.5,4127,6,75,3301,1616,1685
31131,Otoe County,NE,15949,7817,8132,96.1,1096,998,1084,895,1029,1703,1813,2004,990,1283,1570,906,578,41.4,3827,12122,5879,6243,94.2,15002,66,54,11637,5590,6047
31133,Pawnee County,NE,2649,1262,1387,91.0,163,157,140,165,98,213,251,300,222,202,361,235,142,50.0,553,2096,1004,1092,91.9,2558,4,0,2075,1004,1071
31135,Perkins County,NE,2901,1500,1401,107.1,194,201,202,154,145,291,342,287,187,231,357,193,117,42.9,720,2181,1105,1076,102.7,2861,4,0,2153,1088,1065
31137,Phelps County,NE,9100,4562,4538,100.5,526,677,565,563,488,957,1044,1208,576,675,905,596,320,42.4,2154,6946,3423,3523,97.2,8771,33,14,6853,3379,3474
31139,Pierce County,NE,7144,3555,3589,99.1,464,517,490,433,398,739,783,930,571,469,709,494,147,41.6,1790,5354,2658,2696,98.6,6937,15,44,5329,2646,2683
31141,Platte County,NE,33174,16998,16176,105.1,2400,2275,2618,2225,1886,3934,4035,3693,2069,2305,3099,1890,745,38.4,8699,24475,12413,12062,102.9,31464,179,249,22573,11351,11222
31143,Polk County,NE,5225,2546,2679,95.0,266,313,399,356,253,454,562,667,368,448,619,331,189,45.1,1199,4026,1981,2045,96.9,5084,9,0,3940,1940,2000
31145,Red Willow County,NE,10768,5346,5422,98.6,603,596,762,866,581,1164,1251,1169,790,831,1052,751,352,40.7,2457,8311,4126,4185,98.6,10305,66,8,8243,4110,4133
31147,Richardson County,NE,7961,3973,3988,99.6,434,505,457,479,310,770,808,954,558,767,965,616,338,47.7,1701,6260,3049,3211,95.0,7462,16,6,6214,3012,3202
31149,Rock County,NE,1414,736,678,108.6,103,47,73,81,92,172,121,136,83,151,160,103,92,46.2,266,1148,588,560,105.0,1371,21,0,1148,588,560
31151,Saline County,NE,14270,7263,7007,103.7,921,1028,1037,1178,1236,1658,1828,1473,836,1017,1101,611,346,35.5,3542,10728,5509,5219,105.6,12674,354,281,9521,4855,4666
31153,Sarpy County,NE,181232,90695,90537,100.2,13303,14846,13762,12072,11334,26405,25870,22965,10728,9328,12645,5833,2141,34.6,49982,131250,65077,66173,98.3,158414,7120,4627,127165,62974,64191
31155,Saunders County,NE,21165,10692,10473,102.1,1300,1568,1388,1363,1085,2258,2391,2795,1675,1471,2170,1121,580,41.2,5147,16018,8032,7986,100.6,20601,104,89,15949,7982,7967
31157,Scotts Bluff County,NE,36074,17450,18624,93.7,2403,2585,2531,2395,2005,4338,4103,4053,2501,2411,3597,2112,1040,39.5,8973,27101,12918,14183,91.1,33042,321,237,26334,12446,13888
31159,Seward County,NE,17171,8746,8425,103.8,1012,1183,1105,1573,1439,1730,1935,2065,1171,1046,1596,950,366,38.0,4005,13166,6680,6486,103.0,16550,96,84,13043,6601,6442
31161,Sheridan County,NE,5231,2535,2696,94.0,263,318,337,359,238,506,480,602,367,438,706,366,251,46.7,1163,4068,1995,2073,96.2,4322,109,48,4039,1991,2048
31163,Sherman County,NE,3033,1531,1502,101.9,151,161,206,162,134,246,312,350,259,241,410,243,158,49.7,629,2404,1199,1205,99.5,2966,5,9,2384,1180,1204
31165,Sioux County,NE,1219,587,632,92.9,121,73,48,26,114,160,72,108,123,104,111,115,44,44.1,254,965,461,504,91.5,1130,5,0,956,461,495
31167,Stanton County,NE,5957,2984,2973,100.4,379,416,440,361,298,647,677,749,476,469,577,291,177,42.1,1497,4460,2247,2213,101.5,5763,87,29,4375,2185,2190
31169,Thayer County,NE,5057,2542,2515,101.1,306,346,317,233,272,441,504,590,299,466,631,363,289,46.5,1153,3904,1951,1953,99.9,4890,25,0,3888,1937,1951
31171,Thomas County,NE,645,289,356,81.2,35,50,23,37,27,122,53,34,45,82,85,51,1,41.8,127,518,227,291,78.0,613,0,0,518,227,291
31173,Thurston County,NE,7181,3566,3615,98.6,699,696,785,602,532,872,681,690,423,344,486,255,116,27.5,2580,4601,2219,2382,93.2,2753,14,59,4545,2178,2367
31175,Valley County,NE,4206,2048,2158,94.9,250,266,260,243,194,413,428,500,244,341,546,375,146,46.2,938,3268,1576,1692,93.1,4116,20,0,3252,1571,1681
31177,Washington County,NE,20361,10058,10303,97.6,1206,1382,1473,1366,1126,1973,2466,2751,1714,1273,2178,968,485,41.2,5003,15358,7451,7907,94.2,19667,221,53,15233,7403,7830
31179,Wayne County,NE,9332,4742,4590,103.3,477,516,548,1426,1027,886,1010,851,498,646,723,486,238,32.0,1881,7451,3701,3750,98.7,8898,135,43,7244,3517,3727
31181,Webster County,NE,3537,1787,1750,102.1,197,219,265,192,208,340,344,421,301,258,398,283,111,45.1,806,2731,1375,1356,101.4,3375,10,0,2728,1374,1354
31183,Wheeler County,NE,783,413,370,111.6,66,47,23,24,16,88,84,117,60,71,102,79,6,49.4,157,626,328,298,110.1,776,0,2,622,325,297
31185,York County,NE,13745,6708,7037,95.3,857,906,859,841,972,1719,1437,1547,1000,897,1397,892,421,39.9,3162,10583,5003,5580,89.7,13012,214,58,10431,4937,5494
32001,Churchill County,NV,24259,12284,11975,102.6,1677,1553,1462,1248,1501,3164,2565,3185,1865,1509,2750,1391,389,39.7,5536,18723,9463,9260,102.2,19787,599,676,17867,8984,8883
32003,Clark County,NV,2182004,1089228,1092776,99.7,138083,141071,146740,132650,134302,324866,301784,290646,133594,122782,195239,92184,28063,37.3,510453,1671551,828592,842959,98.3,1312652,255174,212385,1444234,717524,726710
32005,Douglas County,NV,48132,24169,23963,100.9,1675,2547,2269,2534,2011,4603,4781,5657,4317,4547,7993,4029,1169,52.0,8171,39961,19969,19992,99.9,42904,364,879,38520,19363,19157
32007,Elko County,NV,52297,27216,25081,108.5,3765,4266,3910,3761,3212,7846,6642,6665,3619,2868,3611,1691,441,34.1,14332,37965,19805,18160,109.1,44789,270,584,35753,18569,17184
32009,Esmeralda County,NV,969,425,544,78.1,28,73,52,12,1,95,124,94,104,110,189,68,19,55.4,161,808,374,434,86.2,927,25,0,758,358,400
32011,Eureka County,NV,1859,939,920,102.1,106,91,197,65,54,137,224,320,141,189,204,77,54,47.7,428,1431,740,691,107.1,1744,1,13,1416,732,684
32013,Humboldt County,NV,16828,8680,8148,106.5,1243,985,1602,1024,860,2471,2126,2073,1147,1038,1501,631,127,36.0,4561,12267,6447,5820,110.8,14531,109,109,11222,5842,5380
32015,Lander County,NV,5643,3091,2552,121.1,310,550,457,256,199,855,664,717,645,192,436,213,149,37.4,1521,4122,2225,1897,117.3,5265,52,6,3785,1993,1792
32017,Lincoln County,NV,5180,2790,2390,116.7,194,215,285,382,391,610,579,641,355,394,702,348,84,44.4,935,4245,2341,1904,123.0,4589,232,46,4187,2308,1879
32019,Lyon County,NV,54380,27450,26930,101.9,2971,3617,2993,3265,2445,6654,6175,6813,3894,4181,7355,3296,721,43.7,11766,42614,21635,20979,103.1,46265,458,707,40500,20405,20095
32021,Mineral County,NV,4460,2216,2244,98.8,187,220,269,272,267,396,340,409,391,350,732,559,68,52.9,827,3633,1769,1864,94.9,3040,229,57,3599,1748,1851
32023,Nye County,NV,44380,22543,21837,103.2,2020,2110,2039,2048,2022,3835,4214,5188,3742,3989,7912,4124,1137,53.1,7596,36784,18727,18057,103.7,36858,846,745,35216,17978,17238
32027,Pershing County,NV,6615,4243,2372,178.9,339,271,347,198,265,1134,1019,1091,401,514,667,315,54,42.1,1110,5505,3760,1745,215.5,5305,253,70,5168,3462,1706
32029,Storey County,NV,3988,2108,1880,112.1,213,187,190,196,184,244,510,521,312,289,759,366,17,50.9,715,3273,1724,1549,111.3,3494,67,37,3217,1721,1496
32031,Washoe County,NV,456936,230091,226845,101.4,27239,27354,28579,27215,30230,68374,55933,58463,30794,29865,46361,19977,6552,38.4,99722,357214,178879,178335,100.3,354407,10630,24401,326210,163197,163013
32033,White Pine County,NV,9679,5688,3991,142.5,513,422,689,539,454,1400,1473,1196,673,720,896,557,147,39.8,1989,7690,4605,3085,149.3,8237,571,87,7415,4403,3012
32510,Carson City,NV,54773,28133,26640,105.6,2971,3210,3096,3026,3146,6981,6278,7087,4075,4046,6327,3183,1347,42.4,11219,43554,22395,21159,105.8,44913,1125,1465,39861,20501,19360
33001,Belknap County,NH,60887,30002,30885,97.1,2668,2702,3872,3408,3123,6323,6631,8554,5276,5293,7935,3483,1619,47.4,11399,49488,24215,25273,95.8,58664,400,569,48788,23859,24929
33003,Carroll County,NH,48138,23882,24256,98.5,1897,2230,2054,2466,2103,4289,4581,6529,4494,4514,7923,3337,1721,52.3,7766,40372,19759,20613,95.9,46773,226,327,40010,19670,20340
33005,Cheshire County,NH,76042,37138,38904,95.5,3458,3666,4126,5788,5813,8938,7810,9886,6111,5727,8782,3972,1965,43.1,13689,62353,30186,32167,93.8,72352,682,959,61694,29947,31747
33007,Coos County,NH,31741,16723,15018,111.4,1269,1317,1606,1613,1632,3465,3499,4587,2690,2743,4218,2153,949,48.2,5246,26495,14017,12478,112.3,29822,824,168,26142,13826,12316
33009,Grafton County,NH,89777,44210,45567,97.0,3712,4130,4130,7122,7400,11051,9143,11204,6976,6945,10508,5073,2383,43.2,14713,75064,36650,38414,95.4,82814,1075,3331,71977,34970,37007
33011,Hillsborough County,NH,413035,205394,207641,98.9,21666,22701,25390,25477,26633,55485,50684,61549,32234,28314,37328,17899,7675,40.7,85564,327471,161555,165916,97.4,369394,12025,16694,311702,153237,158465
33013,Merrimack County,NH,149917,73860,76057,97.1,7134,8247,8107,9805,9977,17962,17503,21633,12558,10675,15646,6793,3877,42.8,29049,120868,59117,61751,95.7,141017,2139,3135,117952,57685,60267
33015,Rockingham County,NH,306359,151844,154515,98.3,13957,16484,17797,18211,17117,35866,35744,48504,27933,21976,32434,14561,5775,44.5,60202,246157,120960,125197,96.6,290182,2550,6321,241060,118278,122782
33017,Strafford County,NH,129124,63204,65920,95.9,6084,6612,7161,10889,13930,16858,14404,16997,9146,8205,11247,5311,2280,36.9,24172,104952,50936,54016,94.3,119599,1284,4331,101478,49093,52385
33019,Sullivan County,NH,43104,21432,21672,98.9,1998,2055,2540,2383,2127,4956,4703,6199,3844,3351,5435,2537,976,46.3,8164,34940,17282,17658,97.9,41511,341,345,34653,17196,17457
34001,Atlantic County,NJ,266105,128791,137314,93.8,14841,15334,16677,16934,17643,31705,29830,37124,21017,18343,26857,14093,5707,41.7,57085,209020,99673,109347,91.2,174978,38907,21006,191846,91641,100205
34003,Bergen County,NJ,930390,451161,479229,94.1,49303,55109,57259,57936,54371,106856,122681,138065,69735,60660,85953,47664,24798,41.9,198254,732136,350033,382103,91.6,666126,55381,151965,637947,304918,333029
34005,Burlington County,NJ,445702,219200,226502,96.8,23072,25917,27447,27063,28258,55063,54887,65596,35238,28993,41766,22211,10191,41.6,93869,351833,171495,180338,95.1,320997,75266,22583,337691,164397,173294
34007,Camden County,NJ,506738,244647,262091,93.3,30972,31790,33088,31293,31128,69734,64083,68913,36426,31520,44568,23075,10148,38.8,115858,390880,185379,205501,90.2,322202,97617,29048,370201,175383,194818
34009,Cape May County,NJ,93086,45495,47591,95.6,4250,4420,4750,4795,5063,9515,8960,11671,6836,8767,13806,7208,3045,49.6,16391,76695,37089,39606,93.6,85095,4187,864,74688,36171,38517
34011,Cumberland County,NJ,151906,77686,74220,104.7,9665,9962,10630,9293,9235,21921,20052,19998,9844,8630,12974,6731,2971,37.6,36173,115733,59327,56406,105.2,103397,29551,2189,106847,54165,52682
34013,Essex County,NJ,795404,382523,412881,92.6,52715,51386,54251,50461,52010,108220,110698,112225,50870,45650,60881,30804,15233,37.6,189366,606038,285997,320041,89.4,341516,315997,42406,517011,242924,274087
34015,Gloucester County,NJ,291165,141404,149761,94.4,15373,18390,18532,19265,18705,35777,36319,42874,21200,19936,26749,12583,5462,40.5,64406,226759,108565,118194,91.9,237131,29570,9045,221906,106000,115906
34017,Hudson County,NJ,670046,333123,336923,98.9,46963,37822,33204,32401,41590,139659,105893,82720,36357,34790,44828,24065,9754,35.3,137582,532464,263055,269409,97.6,366901,81275,101912,394011,190276,203735
34019,Hunterdon County,NJ,124823,62104,62719,99.0,5076,6147,7887,8960,7962,10852,13195,20928,11510,10011,13308,6506,2481,46.3,24805,100018,49377,50641,97.5,113022,3268,5145,95426,47040,48386
34021,Mercer County,NJ,367922,179846,188076,95.6,20876,20898,22891,27095,28628,45618,46997,51875,25590,22513,30883,15723,8335,38.8,78704,289218,139619,149599,93.3,231533,76166,40882,249621,119008,130613
34023,Middlesex County,NJ,825920,407170,418750,97.2,48068,50366,50818,54911,53844,111402,113719,114620,57089,49870,68893,34528,17792,38.6,180478,645442,314939,330503,95.3,478174,85481,198426,541590,262753,278837
34025,Monmouth County,NJ,621659,302256,319403,94.6,30817,37107,39050,41186,37583,66154,71524,95292,52294,44050,61219,30807,14576,43.3,133141,488518,234597,253921,92.4,512161,44513,33559,459299,219715,239584
34027,Morris County,NJ,493379,242146,251233,96.4,24660,28069,31941,33316,29607,53305,60474,77892,38105,33531,45614,24631,12234,42.8,105545,387834,187982,199852,94.1,402269,17023,50794,354560,171130,183430
34029,Ocean County,NJ,596415,287757,308658,93.2,41998,38656,39437,33981,32607,64684,60256,71346,39693,39877,70840,43814,19226,42.7,142499,453916,214703,239213,89.8,542186,18465,11175,437774,206722,231052
34031,Passaic County,NJ,503637,245332,258305,95.0,34223,32233,33939,34128,35309,67744,63450,67568,33134,30012,40896,21446,9555,37.2,120481,383156,183863,199293,92.3,322127,56399,26084,321763,152610,169153
34033,Salem County,NJ,62990,30823,32167,95.8,3441,3946,3778,3852,3897,7108,7403,8750,4429,4849,6557,3342,1638,42.1,13645,49345,23821,25524,93.3,50417,8340,677,48238,23108,25130
34035,Somerset County,NJ,329838,161195,168643,95.6,17018,18973,22857,22204,19288,35762,42821,52620,27024,20881,27923,14892,7575,41.7,73290,256548,123575,132973,92.9,218626,32147,58305,227992,109483,118509
34037,Sussex County,NJ,141483,70411,71072,99.1,6318,7387,8808,9271,8553,14921,16023,22945,12642,10952,14887,6347,2429,44.7,28438,113045,55778,57267,97.4,131300,3290,2963,110283,54623,55660
34039,Union County,NJ,554033,270127,283906,95.1,35098,36710,36455,35194,33972,70748,76066,79892,38851,32422,44042,22944,11639,38.7,130333,423700,203920,219780,92.8,304231,117292,28328,352353,167467,184886
34041,Warren County,NJ,105862,51835,54027,95.9,4777,5742,6357,6904,6484,11512,11997,16677,9180,7594,10466,5415,2757,44.4,21178,84684,41081,43603,94.2,93685,4747,2812,81130,39350,41780
35001,Bernalillo County,NM,677858,332204,345654,96.1,38725,40503,44513,42616,45366,101561,86536,83251,45068,42791,63737,30809,12382,37.6,149559,528299,255844,272455,93.9,503337,20127,17885,492390,236916,255474
35003,Catron County,NM,3526,1944,1582,122.9,102,106,170,225,84,143,383,280,458,269,748,319,239,58.1,540,2986,1667,1319,126.4,3451,0,0,2936,1667,1269
35005,Chaves County,NM,65144,32537,32607,99.8,4419,5122,4694,5252,4283,8354,7427,7555,3871,4067,5707,2920,1473,35.7,17439,47705,23434,24271,96.6,57038,1012,621,43594,21190,22404
35006,Cibola County,NM,26891,13612,13279,102.5,1776,1793,1689,1799,1700,3792,3492,3061,1542,2050,2517,1190,490,37.3,6370,20521,10530,9991,105.4,12932,297,40,20068,10243,9825
35007,Colfax County,NM,12168,6256,5912,105.8,589,743,526,621,548,1276,1231,1309,855,1184,1951,985,350,50.2,2244,9924,4985,4939,100.9,10394,89,52,9774,4894,4880
35009,Curry County,NM,49732,25956,23776,109.2,4087,3616,3569,3321,4605,8579,5866,4892,2672,2434,3332,1975,784,31.5,13206,36526,19047,17479,109.0,33022,2520,643,33546,17568,15978
35011,De Baca County,NM,2040,1043,997,104.6,134,132,249,270,110,120,265,219,62,78,248,102,51,35.4,697,1343,656,687,95.5,1364,32,7,1335,650,685
35013,Doña Ana County,NM,216069,106056,110013,96.4,14013,15219,15391,17177,23311,27838,23561,22635,12151,11733,18991,10793,3256,33.1,53614,162455,78845,83610,94.3,188300,3905,2427,142039,69113,72926
35015,Eddy County,NM,57732,29137,28595,101.9,4235,3991,4578,3938,3745,8235,7038,6537,3763,3418,4623,2416,1215,35.2,15322,42410,21288,21122,100.8,52019,906,265,40163,20091,20072
35017,Grant County,NM,27669,13652,14017,97.4,1479,1467,1637,1637,1504,2864,2865,2814,1898,2157,4295,2131,921,46.4,5578,22091,10700,11391,93.9,25630,275,175,21700,10498,11202
35019,Guadalupe County,NM,4353,2556,1797,142.2,286,236,197,116,210,612,636,465,346,300,494,351,104,43.1,831,3522,2047,1475,138.8,3395,34,9,3475,2022,1453
35021,Harding County,NM,441,242,199,121.6,18,17,17,12,22,45,24,44,32,38,98,49,25,58.5,61,380,230,150,153.3,363,0,0,360,227,133
35023,Hidalgo County,NM,4297,2130,2167,98.3,265,286,254,278,243,434,449,535,299,344,545,254,111,43.1,949,3348,1704,1644,103.6,4031,54,0,3174,1637,1537
35025,Lea County,NM,70277,36269,34008,106.6,5522,6081,6234,5429,4831,10299,8876,7819,3983,3433,4529,2345,896,31.8,21141,49136,25325,23811,106.4,62117,2692,402,41410,21315,20095
35027,Lincoln County,NM,19461,9554,9907,96.4,914,937,1123,812,999,1828,1889,2124,1526,1834,3286,1681,508,50.9,3581,15880,7684,8196,93.8,18843,104,13,15054,7372,7682
35028,Los Alamos County,NM,18625,9463,9162,103.3,1013,1125,1371,1214,642,2248,2254,2611,1591,1296,1903,934,423,42.3,4246,14379,7239,7140,101.4,15929,107,926,13768,6898,6870
35029,Luna County,NM,24083,12026,12057,99.7,1789,1600,1978,1572,1761,2770,2383,2531,1441,1319,2700,1817,422,37.1,6362,17721,8855,8866,99.9,22231,381,199,15074,7600,7474
35031,McKinley County,NM,72438,34986,37452,93.4,5396,5758,6398,5508,5170,10539,8402,8424,4023,4210,5115,2465,1030,32.4,20982,51456,24314,27142,89.6,10426,474,829,50648,23952,26696
35033,Mora County,NM,4536,2201,2335,94.3,119,179,121,310,289,459,230,549,454,447,851,327,201,55.2,526,4010,1933,2077,93.1,2991,2,0,3995,1933,2062
35035,Otero County,NM,66137,34214,31923,107.2,4476,4537,4058,3977,5510,9724,7401,7149,4147,3910,6398,3736,1114,35.8,15446,50691,26255,24436,107.4,52309,2343,858,46079,23414,22665
35037,Quay County,NM,8326,3976,4350,91.4,488,653,505,417,331,943,995,715,701,557,1183,641,197,43.4,1888,6438,3126,3312,94.4,7373,138,75,6257,3018,3239
35039,Rio Arriba County,NM,39159,18819,20340,92.5,2557,2503,2593,2531,2265,4458,4348,4880,2758,2960,4282,2131,893,41.3,9211,29948,14568,15380,94.7,20775,251,191,29180,14275,14905
35041,Roosevelt County,NM,18888,9401,9487,99.1,1328,1360,1195,1693,2499,2453,1889,1902,996,951,1420,864,338,30.0,4606,14282,7047,7235,97.4,14255,530,121,12947,6402,6545
35043,Sandoval County,NM,142704,69943,72761,96.1,7815,9406,10316,9589,7648,17782,18052,17970,9895,9831,15443,6737,2220,40.1,33635,109069,52657,56412,93.3,102859,3327,1976,106670,51473,55197
35045,San Juan County,NM,126515,62677,63838,98.2,8635,9461,10190,8888,7775,17481,15613,14315,8593,7535,10524,5200,2305,35.4,34030,92485,45334,47151,96.1,66160,1041,984,90225,44046,46179
35047,San Miguel County,NM,27738,13825,13913,99.4,1362,1305,1509,2069,1860,3130,3001,3434,2002,2354,3425,1614,673,44.0,5281,22457,11158,11299,98.8,16882,365,341,21829,10902,10927
35049,Santa Fe County,NM,149293,72380,76913,94.1,6503,7589,8384,8159,7854,16747,16917,18948,11687,11967,22262,9066,3210,46.3,27490,121803,58617,63186,92.8,125090,1574,1889,111132,52850,58282
35051,Sierra County,NM,11031,5463,5568,98.1,497,419,553,498,436,728,966,1239,830,944,2124,1353,444,55.7,1743,9288,4578,4710,97.2,9907,44,83,8979,4403,4576
35053,Socorro County,NM,16858,8815,8043,109.6,801,1227,1198,1310,1307,1778,1686,2053,1044,1276,1978,707,493,39.4,3843,13015,6594,6421,102.7,13439,95,553,12309,6292,6017
35055,Taos County,NM,32786,16137,16649,96.9,1463,1777,1626,1834,1752,2954,3552,4084,2414,3050,5094,2574,612,48.8,5915,26871,13140,13731,95.7,27682,154,282,25797,12501,13296
35057,Torrance County,NM,15519,8251,7268,113.5,793,877,975,1073,1034,1581,1755,1877,1260,1174,1993,998,129,43.6,3276,12243,6518,5725,113.9,14122,121,23,11893,6297,5596
35059,Union County,NM,4133,2221,1912,116.2,226,384,151,75,277,618,560,447,306,273,417,256,143,39.8,836,3297,1897,1400,135.5,3583,67,1,3191,1854,1337
35061,Valencia County,NM,76027,38244,37783,101.2,4325,4978,5518,5145,4730,9230,8890,9619,5134,5376,7911,3897,1274,38.9,18028,57999,28845,29154,98.9,63117,1059,707,55295,27424,27871
36001,Albany County,NY,306968,148624,158344,93.9,15580,14922,16148,23316,32084,40297,34918,38454,20297,20261,28867,14211,7613,37.8,56900,250068,119589,130479,91.7,231246,38035,20192,237094,113281,123813
36003,Allegany County,NY,46688,23678,23010,102.9,2408,2579,2747,4652,4264,4731,4587,5475,3247,3402,5017,2514,1065,39.1,9441,37247,18776,18471,101.7,44565,700,548,36677,18549,18128
36005,Bronx County,NY,1435068,676437,758631,89.2,104886,97497,98083,96789,108267,228450,181385,182169,83464,74417,100267,56343,23051,34.2,358404,1076664,493763,582901,84.7,315533,504814,52989,849351,382224,467127
36007,Broome County,NY,193188,95077,98111,96.9,10106,10742,9965,15059,19252,21504,19807,23237,14420,12989,19086,11266,5755,39.9,37628,155560,75587,79973,94.5,165108,10918,8389,150199,72688,77511
36009,Cattaraugus County,NY,77121,38322,38799,98.8,4399,4673,5079,5245,4876,8427,8250,10110,6024,5611,8319,4352,1756,42.0,17184,59937,29492,30445,96.9,70859,1116,610,59389,29213,30176
36011,Cayuga County,NY,77425,39757,37668,105.5,3890,4252,4357,4689,4801,9440,9079,10691,6320,5694,8235,3917,2060,42.9,15394,62031,31732,30299,104.7,71056,3303,441,61237,31274,29963
36013,Chautauqua County,NY,128496,63355,65141,97.3,7003,6754,7745,9164,8313,15053,13501,16385,10071,9350,14017,7563,3577,42.6,26320,102176,50017,52159,95.9,118515,3338,723,100841,49331,51510
36015,Chemung County,NY,84895,42056,42839,98.2,4938,5049,5111,5132,5061,10492,9982,11115,6561,5840,8689,4380,2545,41.3,18327,66568,32835,33733,97.3,74766,5324,1135,65523,32239,33284
36017,Chenango County,NY,47909,24003,23906,100.4,2556,2659,2918,2795,2637,5295,5162,6675,3620,3915,5665,3014,998,44.9,9951,37958,18926,19032,99.4,46037,467,218,37668,18825,18843
36019,Clinton County,NY,80583,41257,39326,104.9,3918,3911,4227,5912,7404,10230,9373,10737,6005,5648,7642,4009,1567,39.5,14528,66055,33885,32170,105.3,73237,3447,1133,64359,32998,31361
36021,Columbia County,NY,60371,30178,30193,100.0,2557,2846,3000,3223,3171,6574,6415,8654,4969,5026,8078,4222,1636,48.2,10651,49720,24604,25116,98.0,53725,2741,1084,47889,23550,24339
36023,Cortland County,NY,47865,23443,24422,96.0,2376,2674,2463,4458,5781,5535,4808,5879,3354,2869,4456,2210,1002,36.4,9167,38698,18637,20061,92.9,45302,928,364,38391,18457,19934
36025,Delaware County,NY,44995,22703,22292,101.8,1752,2065,2320,3318,2753,4428,4221,5893,3563,3894,6255,3320,1213,47.9,7686,37309,18755,18554,101.1,42629,802,349,36505,18423,18082
36027,Dutchess County,NY,293754,146061,147693,98.9,13537,14166,17163,21556,21719,34317,33735,43441,23331,20613,28334,15310,6532,42.2,56196,237558,117364,120194,97.6,229746,30970,10413,224529,110759,113770
36029,Erie County,NY,919355,444825,474530,93.7,50350,50598,52514,58499,61413,130105,102040,120148,68568,63376,89861,47245,24638,40.3,187572,731783,349330,382453,91.3,715409,123742,32793,706724,336971,369753
36031,Essex County,NY,37459,19504,17955,108.6,1478,1700,1708,1974,1932,4522,4150,5211,3254,3005,4871,2583,1071,47.7,6154,31305,16306,14999,108.7,34788,1194,103,30560,15889,14671
36033,Franklin County,NY,50477,27483,22994,119.5,2485,3049,2751,3098,4029,6862,5978,6822,3711,3327,5024,2578,763,39.9,10060,40417,22338,18079,123.6,41726,2863,280,39776,21827,17949
36035,Fulton County,NY,53646,26800,26846,99.8,2710,2961,3261,3048,3065,6418,6193,7770,3967,4042,5898,2844,1469,43.9,10936,42710,21130,21580,97.9,50640,1119,417,42503,21061,21442
36037,Genesee County,NY,57808,28941,28867,100.3,2967,3370,3310,3335,3492,7353,6306,8181,4910,3991,5784,3279,1530,43.1,11757,46051,23017,23034,99.9,53142,1214,455,45503,22667,22836
36039,Greene County,NY,47424,24796,22628,109.6,2019,1932,2463,2649,3002,5767,5087,6787,3682,3774,6078,2869,1315,45.9,7909,39515,20653,18862,109.5,42486,2758,497,38783,20272,18511
36041,Hamilton County,NY,4515,2264,2251,100.6,145,167,179,277,180,298,383,601,582,337,841,373,152,55.3,625,3890,1945,1945,100.0,4394,36,3,3881,1941,1940
36043,Herkimer County,NY,62057,30721,31336,98.0,3165,3543,3821,4002,3794,6810,6633,8362,4741,4703,7095,3701,1687,44.2,12870,49187,24114,25073,96.2,59365,836,373,48657,23799,24858
36045,Jefferson County,NY,112842,59266,53576,110.6,8918,7765,6720,6651,11248,19172,12911,12353,6258,5923,8736,4395,1792,32.5,27282,85560,45379,40181,112.9,97448,6932,1983,83757,44658,39099
36047,Kings County,NY,2589974,1227099,1362875,90.0,190959,159422,155921,138939,164486,474438,358925,306864,147187,140539,199134,106619,46541,35.2,594646,1995328,923027,1072301,86.1,1132426,833683,307081,1656735,756678,900057
36049,Lewis County,NY,26572,13307,13265,100.3,1688,1555,1823,1642,1504,3044,2920,3507,2190,1944,2674,1374,707,42.2,6127,20445,10244,10201,100.4,25725,185,141,20137,10059,10078
36051,Livingston County,NY,63591,31998,31593,101.3,2739,2999,3460,5323,6392,6962,6682,8632,4832,4641,6383,3197,1349,41.3,11390,52201,26132,26069,100.2,58916,1813,830,50979,25527,25452
36053,Madison County,NY,71205,35171,36034,97.6,3361,4124,3629,6377,5747,7406,7393,9754,5581,5283,7350,3602,1598,41.9,13815,57390,28138,29252,96.2,67360,1268,638,56593,27774,28819
36055,Monroe County,NY,743341,358722,384619,93.3,41286,42091,44743,50700,51845,104611,83726,97031,52286,49678,71093,36049,18202,38.9,155932,587409,279211,308198,90.6,564617,113808,27115,563856,267078,296778
36057,Montgomery County,NY,49302,24255,25047,96.8,3107,3181,2981,3061,2773,6226,5599,6343,3666,3345,5018,2558,1444,41.0,11306,37996,18444,19552,94.3,42970,1091,362,37329,18083,19246
36059,Nassau County,NY,1356509,660093,696416,94.8,74228,80895,84204,87779,86390,156728,162394,193803,100460,92645,129739,66763,40481,41.7,293742,1062767,509487,553280,92.1,922873,158857,130971,965968,460971,504997
36061,New York County,NY,1631993,772614,859379,89.9,78773,61747,60655,68479,112974,364775,233817,201727,94093,90597,144598,80610,39148,37.5,234936,1397057,654102,742955,88.0,922033,240993,198833,1177453,544297,633156
36063,Niagara County,NY,210820,102775,108045,95.1,11099,10681,12929,12920,12465,26305,23415,28707,16259,16823,22449,11418,5350,43.2,42524,168296,81131,87165,93.1,183860,14806,2337,165567,79870,85697
36065,Oneida County,NY,229959,114666,115293,99.5,13016,13862,13578,15010,15549,28588,25347,30584,16583,15567,23127,12414,6734,41.0,48925,181034,89579,91455,97.9,196219,13771,9304,175237,86613,88624
36067,Onondaga County,NY,462872,223287,239585,93.2,26367,27175,27707,33887,31858,61649,51724,60984,33406,31282,43155,21562,12116,39.1,99083,363789,172673,191116,90.3,368328,52912,17041,349818,165433,184385
36069,Ontario County,NY,109511,53619,55892,95.9,5436,6043,6644,7332,6884,12001,11907,15374,8530,8153,12530,6012,2665,43.7,22319,87192,42209,44983,93.8,101371,2769,1501,85459,41303,44156
36071,Orange County,NY,380085,190453,189632,100.4,25153,26716,27985,28838,28618,43974,45132,53566,25440,22712,30664,14539,6748,37.0,97292,282793,140394,142399,98.6,281683,41779,10280,268152,132851,135301
36073,Orleans County,NY,40904,20443,20461,99.9,2063,2187,2171,2572,2412,5354,4721,5957,3426,2943,4139,2079,880,43.0,8054,32850,16282,16568,98.3,36345,2383,250,32294,15933,16361
36075,Oswego County,NY,118339,59267,59072,100.3,6464,6675,7420,9141,8546,14213,12875,16855,9207,8275,11265,5258,2145,40.3,25122,93217,46268,46949,98.5,113114,1352,884,92313,45867,46446
36077,Otsego County,NY,59972,28923,31049,93.2,2539,2496,2844,5546,6608,5844,5613,7248,4587,4314,7083,3710,1540,42.3,9703,50269,23965,26304,91.1,56036,1303,814,49439,23605,25834
36079,Putnam County,NY,98787,49221,49566,99.3,4393,4731,6588,6348,6163,10682,11599,16183,8082,7514,9944,4931,1629,44.2,19868,78919,39188,39731,98.6,85846,3030,2039,74255,36663,37592
36081,Queens County,NY,2287388,1109772,1177616,94.2,143079,121021,125731,116565,135596,369938,315578,312654,157023,139689,196208,105918,48388,39.0,462323,1825065,872677,952388,91.6,875191,418429,583459,1398537,662373,736164
36083,Rensselaer County,NY,159185,78848,80337,98.1,8286,8538,8726,11102,10798,22328,18710,21448,11495,11447,15608,7141,3558,39.8,31081,128104,62783,65321,96.1,137002,10268,4282,124221,60381,63840
36085,Richmond County,NY,474893,230060,244833,94.0,27274,28890,29500,29319,29249,63891,59628,66648,33716,31336,44382,22158,8902,40.1,104238,370655,176623,194032,91.0,352034,48958,44246,336819,159642,177177
36087,Rockland County,NY,324422,159114,165308,96.3,25653,24713,25403,23525,21537,37413,35817,40641,20851,18458,27533,15780,7098,36.0,90892,233530,112769,120761,93.4,229240,39845,19099,208109,99690,108419
36089,St. Lawrence County,NY,108913,55356,53557,103.4,5671,6018,6635,9841,9091,12715,11708,13797,7678,7361,10604,5341,2453,39.0,22173,86740,43990,42750,102.9,101115,2654,1100,84661,42871,41790
36091,Saratoga County,NY,228502,113004,115498,97.8,11704,13172,12870,14538,13208,27041,28418,34474,17611,15275,24329,11499,4363,42.8,46489,182013,89280,92733,96.3,211792,3992,6697,177246,86794,90452
36093,Schenectady County,NY,154859,75505,79354,95.1,9055,9532,9026,9901,10670,19799,18951,20574,10758,10538,14245,7436,4374,39.7,33474,121385,58278,63107,92.3,118130,15590,7228,116017,55573,60444
36095,Schoharie County,NY,31222,15500,15722,98.6,1316,1631,1518,2444,2004,3270,3240,4246,2692,2308,3864,2007,682,45.4,5543,25679,12704,12975,97.9,29791,496,281,25381,12587,12794
36097,Schuyler County,NY,17920,8965,8955,100.1,899,885,993,1012,902,2060,1892,2588,1468,1494,2239,1038,450,46.4,3450,14470,7173,7297,98.3,17289,182,126,14348,7129,7219
36099,Seneca County,NY,34390,17957,16433,109.3,1841,1747,2042,1872,2178,4798,3811,4497,2857,2334,3766,1894,753,42.1,6879,27511,14384,13127,109.6,31355,1744,285,27163,14202,12961
36101,Steuben County,NY,96422,48131,48291,99.7,5334,5806,5931,5879,5386,11188,11075,12997,7512,7063,10453,5665,2133,42.9,20906,75516,37311,38205,97.7,91286,1623,1480,74030,36543,37487
36103,Suffolk County,NY,1483832,730427,753405,97.0,79799,82728,94954,98554,96955,173683,175970,225272,111446,99600,138089,73674,33108,41.5,318213,1165619,567980,597639,95.0,1196719,116018,58204,1074313,520683,553630
36105,Sullivan County,NY,75116,38485,36631,105.1,4257,4125,4725,4611,4312,8949,8389,10657,5721,5442,8534,4233,1161,42.8,15942,59174,30331,28843,105.2,59949,5990,1265,55984,28500,27484
36107,Tioga County,NY,48686,24144,24542,98.4,2474,2582,3249,2991,2694,5112,5455,6660,4548,3317,5331,3130,1143,44.5,10271,38415,18893,19522,96.8,46870,327,374,38003,18727,19276
36109,Tompkins County,NY,102642,50677,51965,97.5,4121,4051,4299,13197,17200,12982,10418,10469,5728,5882,8643,3709,1943,31.1,15268,87374,42601,44773,95.1,82359,3859,9964,79849,38527,41322
36111,Ulster County,NY,178665,88488,90177,98.1,7856,8775,9327,10917,11600,22154,20630,25549,14727,12876,20356,9716,4182,44.0,31925,146740,72454,74286,97.5,151001,10780,3396,141256,69537,71719
36113,Warren County,NY,64276,31642,32634,97.0,2781,3139,3608,3469,3446,7622,6797,9161,5044,5322,8169,3859,1859,46.8,11808,52468,25482,26986,94.4,61452,828,641,51731,25063,26668
36115,Washington County,NY,61616,31902,29714,107.4,2896,3473,3240,3408,3607,7282,7516,9125,5147,4302,6778,3445,1397,44.2,11736,49880,25822,24058,107.3,57686,1969,371,49321,25486,23835
36117,Wayne County,NY,90519,44902,45617,98.4,4964,5236,5812,5500,5093,9963,10000,13278,7173,6869,9948,4759,1924,43.8,19490,71029,35012,36017,97.2,84123,2543,725,70257,34576,35681
36119,Westchester County,NY,968890,469169,499721,93.9,54551,57237,63612,65251,59949,110783,123298,141287,69462,61249,86662,49244,26305,40.9,215101,753789,358159,395630,90.5,622855,144053,58140,653874,307210,346664
36121,Wyoming County,NY,40305,21537,18768,114.8,2080,2182,2261,2317,2432,5442,4677,5915,3147,2856,4280,1974,742,42.2,8016,32289,17512,14777,118.5,36882,1669,167,31715,17106,14609
36123,Yates County,NY,25011,11952,13059,91.5,1496,1477,1596,1844,1925,2657,2336,2875,2008,1767,2940,1530,560,41.0,5555,19456,9225,10231,90.2,24122,254,163,19241,9157,10084
37001,Alamance County,NC,163324,77542,85782,90.4,9508,9629,10889,12800,10626,20101,19075,22339,11093,10099,15404,8268,3493,39.1,36538,126786,58853,67933,86.6,113953,31926,2602,118587,54437,64150
37003,Alexander County,NC,37213,18940,18273,103.7,1869,1863,2442,2153,2059,4369,4531,5348,2827,2504,4168,2220,860,43.7,7568,29645,15200,14445,105.2,32622,2173,389,28937,14904,14033
37005,Alleghany County,NC,11008,5404,5604,96.4,456,495,615,595,426,1086,1142,1464,780,1032,1639,992,286,50.1,1918,9090,4491,4599,97.7,10501,267,50,8716,4224,4492
37007,Anson County,NC,24902,13056,11846,110.2,1172,1357,1411,1463,1486,3560,3165,3372,1697,1758,2693,1257,511,40.9,4831,20071,10638,9433,112.8,11892,12094,331,19678,10320,9358
37009,Ashe County,NC,26863,13207,13656,96.7,1142,1210,1562,1337,1256,2743,3077,3620,1978,2304,3921,2060,653,48.3,4856,22007,10677,11330,94.2,25628,197,120,21415,10322,11093
37011,Avery County,NC,17506,9616,7890,121.9,590,677,802,1018,1095,2158,2358,2494,1102,1409,2238,1183,382,45.2,2580,14926,8318,6608,125.9,16109,693,77,14524,8083,6441
37013,Beaufort County,NC,47168,22529,24639,91.4,2338,2415,3040,2777,2428,4663,5144,6068,3632,3650,6638,3151,1224,46.2,9608,37560,17575,19985,87.9,33969,11782,52,36442,17106,19336
37015,Bertie County,NC,19380,9689,9691,100.0,825,1004,958,1026,1171,2454,2133,2443,1456,1666,2362,1337,545,45.4,3394,15986,8014,7972,100.5,6830,11933,151,15849,7943,7906
37017,Bladen County,NC,33407,16030,17377,92.2,1760,1812,2161,2201,1502,3663,3849,4264,2348,2819,4274,2084,670,44.5,6991,26416,12378,14038,88.2,19260,11594,50,25407,11804,13603
37019,Brunswick County,NC,131815,63419,68396,92.7,5285,5869,5874,5624,5182,12146,12814,15102,10366,13330,27400,10295,2528,53.8,20627,111188,52767,58421,90.3,110980,12864,766,109082,51659,57423
37021,Buncombe County,NC,256886,123240,133646,92.2,12803,12886,14014,14039,14444,35441,34075,33353,17323,18583,29491,13691,6743,42.2,48156,208730,98505,110225,89.4,228237,16101,3249,200455,94057,106398
37023,Burke County,NC,89968,44804,45164,99.2,4262,4439,4981,5843,5223,10578,10507,12934,6834,6664,10181,5425,2097,44.1,17044,72924,36035,36889,97.7,75887,5477,3252,70809,34928,35881
37025,Cabarrus County,NC,206615,100729,105886,95.1,13200,13513,17106,14360,11548,25664,29928,30346,13128,10933,16392,7604,2893,37.9,53310,153305,73341,79964,91.7,145738,37166,7700,144251,68301,75950
37027,Caldwell County,NC,81884,40432,41452,97.5,4115,4557,4746,5023,4433,9100,9346,12621,6430,5681,9448,4784,1600,44.6,16690,65194,31961,33233,96.2,72802,3779,415,63580,31100,32480
37029,Camden County,NC,10551,5587,4964,112.6,485,632,876,642,473,1133,1418,1691,689,665,1105,533,209,41.0,2393,8158,4147,4011,103.4,8718,1460,189,8068,4137,3931
37031,Carteret County,NC,69070,33874,35196,96.2,2917,3406,3659,3613,3262,6775,7684,9450,5504,6057,10241,4881,1621,48.6,12271,56799,27473,29326,93.7,62094,3685,808,55780,26902,28878
37033,Caswell County,NC,22684,11395,11289,100.9,1048,1091,1353,1244,1233,2422,2673,3248,1977,1700,2839,1316,540,45.7,4269,18415,9274,9141,101.5,14307,7425,152,18069,9062,9007
37035,Catawba County,NC,157613,77099,80514,95.8,8889,9257,10656,10352,9404,18289,19109,22412,11652,10058,16633,8148,2754,41.4,35250,122363,59068,63295,93.3,124641,12896,6855,116531,56363,60168
37037,Chatham County,NC,71338,34010,37328,91.1,3461,4036,4450,3819,3365,6130,8365,10007,5305,5271,9997,4675,2457,46.7,14589,56749,26864,29885,89.9,57718,8041,1068,52937,24967,27970
37039,Cherokee County,NC,27969,13716,14253,96.2,1079,1183,1586,1390,1212,2465,2811,3512,2112,2522,4932,2414,751,51.5,4745,23224,11221,12003,93.5,26095,348,203,22882,10969,11913
37041,Chowan County,NC,14097,6575,7522,87.4,639,528,1038,851,447,1846,1542,1573,1105,1113,1983,890,542,46.0,2912,11185,5190,5995,86.6,8615,4967,46,11120,5132,5988
37043,Clay County,NC,10946,5213,5733,90.9,408,634,736,323,469,980,1021,1236,760,1081,1980,1127,191,52.2,1916,9030,4249,4781,88.9,10580,228,22,8868,4180,4688
37045,Cleveland County,NC,97282,47012,50270,93.5,5431,5904,6186,6555,6360,10899,10968,13649,7242,6396,10577,5278,1837,41.8,21412,75870,36019,39851,90.4,72575,20386,1006,74651,35335,39316
37047,Columbus County,NC,56068,27857,28211,98.7,2881,3342,3417,3627,3397,6849,6516,7453,3742,3908,6479,3466,991,41.9,11961,44107,21787,22320,97.6,34778,17089,228,43152,21291,21861
37049,Craven County,NC,102491,51769,50722,102.1,6527,6264,6088,6162,9997,13552,11403,10614,6108,6599,11134,5901,2142,37.0,22337,80154,40556,39598,102.4,72130,22169,2823,77997,39401,38596
37051,Cumberland County,NC,332861,165585,167276,99.0,25245,22960,21406,22966,34376,57027,39076,36318,18778,16187,22922,11715,3885,31.3,82308,250553,123848,126705,97.7,166394,123259,8267,242505,120567,121938
37053,Currituck County,NC,26363,13103,13260,98.8,1426,1826,1519,1597,1200,3039,3417,3974,2116,2072,2700,1071,406,42.8,5837,20526,10114,10412,97.1,23822,1461,114,20343,9969,10374
37055,Dare County,NC,36222,18110,18112,100.0,1568,2019,2170,1840,1677,3548,4565,5006,2936,3394,4918,2070,511,46.5,6981,29241,14324,14917,96.0,33591,1086,279,28224,13872,14352
37057,Davidson County,NC,165381,80791,84590,95.5,9046,10190,10636,10161,9149,18924,19692,24604,12638,10858,17256,9467,2760,42.5,36654,128727,62083,66644,93.2,141830,15232,2586,123771,59606,64165
37059,Davie County,NC,42257,20485,21772,94.1,2062,2566,2602,2645,2149,4211,4798,6422,3126,3121,4906,2948,701,45.2,9015,33242,15883,17359,91.5,37753,2094,300,32039,15254,16785
37061,Duplin County,NC,58967,28715,30252,94.9,3693,4229,3858,3831,3448,6636,6967,7571,4159,3995,6192,3107,1281,40.5,14319,44648,21327,23321,91.4,42010,14006,223,39180,18266,20914
37063,Durham County,NC,311848,149039,162809,91.5,20472,18702,16746,20044,21591,56279,44228,38414,18465,17641,24357,10269,4640,35.4,65821,246027,115573,130454,88.6,161919,113682,15279,219327,100934,118393
37065,Edgecombe County,NC,52648,24421,28227,86.5,3058,2976,3879,3194,3207,6205,5693,6584,3815,4052,5927,3004,1054,41.7,12012,40636,18256,22380,81.6,20721,30332,113,39951,17859,22092
37067,Forsyth County,NC,375195,177935,197260,90.2,22660,24981,24349,26933,24608,49008,45304,50149,26502,22232,34235,17626,6608,38.4,87038,288157,133548,154609,86.4,247912,98362,8830,269429,124010,145419
37069,Franklin County,NC,66362,32942,33420,98.6,3725,3665,4674,4269,3939,7590,8271,9624,4958,4739,6735,3206,967,41.4,14716,51646,25408,26238,96.8,44679,16594,329,49311,23961,25350
37071,Gaston County,NC,219271,105755,113516,93.2,13080,13799,14141,13793,12902,28416,27746,31851,14456,14370,20914,9919,3884,40.1,49808,169463,80428,89035,90.3,168959,35824,3357,163318,77270,86048
37073,Gates County,NC,11548,5641,5907,95.5,461,713,782,616,617,1173,1157,1834,1033,879,1453,601,229,46.5,2361,9187,4474,4713,94.9,7314,3859,61,9157,4464,4693
37075,Graham County,NC,8509,4136,4373,94.6,379,483,570,619,379,819,906,1192,543,648,1111,540,320,46.2,1749,6760,3249,3511,92.5,7436,17,0,6661,3186,3475
37077,Granville County,NC,59328,30241,29087,104.0,2940,3287,3740,3829,3642,6776,7436,9168,4988,3664,5990,3013,855,42.7,12301,47027,23870,23157,103.1,36216,17842,312,45560,23002,22558
37079,Greene County,NC,21033,11674,9359,124.7,1051,1247,1250,1185,1317,2798,3102,2696,1608,1463,1987,991,338,40.7,4313,16720,9262,7458,124.2,12519,7334,17,15500,8485,7015
37081,Guilford County,NC,527868,249974,277894,90.0,31282,31530,34658,40020,38337,72567,65029,70725,34152,31358,45884,22597,9729,37.1,118144,409724,189940,219784,86.4,291462,178875,26115,382316,175494,206822
37083,Halifax County,NC,51190,24757,26433,93.7,2767,2893,3422,3073,2888,5894,5504,6772,3897,3779,5962,3135,1204,43.4,11011,40179,18994,21185,89.7,20721,27013,374,39784,18813,20971
37085,Harnett County,NC,132283,65571,66712,98.3,9852,9823,9874,9031,8144,20799,18008,16372,7571,6720,9810,4843,1436,34.4,34901,97382,47666,49716,95.9,88760,27536,1490,92632,45138,47494
37087,Haywood County,NC,61053,29481,31572,93.4,3014,2625,3415,3243,2954,6819,6707,8085,4450,4876,8603,4656,1606,47.6,11149,49904,23692,26212,90.4,58313,572,399,49153,23237,25916
37089,Henderson County,NC,114913,55243,59670,92.6,5606,6545,5976,6066,5221,11565,13058,14877,8177,8590,16489,9005,3738,47.4,22061,92852,43928,48924,89.8,104809,4002,1537,88100,41251,46849
37091,Hertford County,NC,24012,11901,12111,98.3,1109,1018,1571,2018,1641,2796,2554,2984,1883,1785,2625,1475,553,42.2,4563,19449,9597,9852,97.4,8422,14263,184,18951,9243,9708
37093,Hoke County,NC,53957,26783,27174,98.6,4670,4026,4066,3403,3121,9680,7772,6245,3196,2585,3389,1214,590,32.8,14911,39046,19081,19965,95.6,23935,18259,816,37009,18193,18816
37095,Hyde County,NC,5213,2745,2468,111.2,253,306,284,410,148,578,853,671,284,414,649,325,38,40.9,1091,4122,2185,1937,112.8,3468,1550,0,3949,2104,1845
37097,Iredell County,NC,175538,86425,89113,97.0,9693,10601,12643,11832,10084,20658,22427,26805,13154,10341,16583,8092,2625,40.6,40661,134877,65678,69199,94.9,142604,21339,4394,128422,62348,66074
37099,Jackson County,NC,42938,20985,21953,95.6,2030,1863,1999,4313,5317,4659,4287,4757,2490,2953,5108,2520,642,37.7,7210,35728,17206,18522,92.9,35688,956,315,34530,16423,18107
37101,Johnston County,NC,196870,96841,100029,96.8,12465,13568,15655,13404,10949,23980,27662,29689,12583,11317,16279,6867,2452,38.4,50504,146366,70864,75502,93.9,152007,31423,1242,135660,65532,70128
37103,Jones County,NC,9594,4750,4844,98.1,419,451,594,560,330,1152,966,1310,827,794,1306,687,198,48.5,1813,7781,3670,4111,89.3,6303,2923,8,7660,3608,4052
37105,Lee County,NC,60481,29309,31172,94.0,3900,3915,4427,4023,3484,7643,7496,7995,4056,3797,5717,2955,1073,38.6,14751,45730,21850,23880,91.5,44592,12273,807,42166,19788,22378
37107,Lenoir County,NC,56756,27219,29537,92.2,3245,3841,3500,3373,3183,6560,6052,7431,4298,4189,6330,3352,1402,42.7,12781,43975,20641,23334,88.5,31205,22205,279,42325,19585,22740
37109,Lincoln County,NC,82919,41244,41675,99.0,4285,4953,5249,5068,4327,8860,10619,12969,6952,5536,8780,3911,1410,43.3,17764,65155,31941,33214,96.2,74133,4125,593,63439,31117,32322
37111,McDowell County,NC,45227,22752,22475,101.2,2045,3101,2592,2339,2293,5282,5550,6269,3598,3167,5298,2868,825,43.9,9258,35969,17641,18328,96.3,41437,1628,415,34850,17064,17786
37113,Macon County,NC,34813,16864,17949,94.0,1684,1468,2062,1812,1552,3592,3254,4182,2632,2706,5653,3075,1141,50.1,6394,28419,13496,14923,90.4,32536,580,302,27265,12812,14453
37115,Madison County,NC,21499,10526,10973,95.9,1002,1074,1006,1664,1428,2252,2483,2740,1520,1647,2775,1492,416,44.0,3924,17575,8521,9054,94.1,20504,349,125,17338,8344,8994
37117,Martin County,NC,22849,10777,12072,89.3,1252,1087,1536,1308,1171,2428,2317,2983,1991,1679,3026,1505,566,46.3,4688,18161,8358,9803,85.3,12460,9625,139,17877,8240,9637
37119,Mecklenburg County,NC,1074475,516517,557958,92.6,72224,71671,70714,68439,70505,182040,158761,145460,63311,54058,72212,32339,12741,35.1,256258,818217,386687,431530,89.6,577943,339021,62922,724170,336918,387252
37121,Mitchell County,NC,15004,7476,7528,99.3,706,668,884,870,774,1672,1543,1948,1166,1115,2067,1108,483,47.0,2810,12194,5966,6228,95.8,14474,57,27,11770,5761,6009
37123,Montgomery County,NC,27252,13345,13907,96.0,1672,1420,1845,1733,1614,2998,2860,3772,2018,1944,3282,1558,536,43.6,6102,21150,10297,10853,94.9,20612,4794,393,19543,9451,10092
37125,Moore County,NC,97294,46871,50423,93.0,5650,6100,5522,5438,4461,10928,11214,11757,6284,6762,12327,7801,3050,44.3,20767,76527,36254,40273,90.0,79973,12052,1239,74326,34906,39420
37127,Nash County,NC,94030,45074,48956,92.1,5241,5840,5911,6121,6116,10734,10762,13067,6798,6713,10165,4808,1754,41.7,20882,73148,34427,38721,88.9,48968,36961,820,70999,33232,37767
37129,New Hanover County,NC,227938,108794,119144,91.3,11266,11691,12429,15033,21596,30224,28707,28339,15043,14350,23710,11186,4364,39.1,42675,185263,86976,98287,88.5,184851,31337,3012,180146,84556,95590
37131,Northampton County,NC,19946,9699,10247,94.7,863,988,1068,1078,956,2075,1931,2540,1589,1858,2823,1647,530,49.6,3537,16409,7847,8562,91.6,7900,11246,56,16199,7741,8458
37133,Onslow County,NC,195069,107985,87084,124.0,17372,12873,11433,14301,34412,36033,19992,15799,8121,7278,10296,5551,1608,26.4,47630,147439,83754,63685,131.5,145758,27291,4210,144804,82540,62264
37135,Orange County,NC,144836,69204,75632,91.5,6604,8055,8614,13943,17594,17957,16674,18481,8612,8899,12411,5053,1939,34.8,28517,116319,54454,61865,88.0,109195,16562,11363,106915,49574,57341
37137,Pamlico County,NC,12701,6464,6237,103.6,413,488,605,572,678,1239,1337,1431,944,1294,2215,1064,421,52.4,1929,10772,5472,5300,103.2,9664,2341,77,10585,5355,5230
37139,Pasquotank County,NC,39514,19268,20246,95.2,2614,2498,2365,2534,2579,5501,4556,4923,2911,2515,3922,1735,861,38.6,8811,30703,14764,15939,92.6,23087,14449,485,30064,14386,15678
37141,Pender County,NC,60399,29972,30427,98.5,3398,3647,4022,3691,3069,6646,7674,8624,4548,4368,6645,3011,1056,42.7,13474,46925,23135,23790,97.2,46947,8612,263,45485,22291,23194
37143,Perquimans County,NC,13430,6533,6897,94.7,599,696,825,756,462,1306,1268,1701,926,1254,2163,1138,336,49.8,2538,10892,5219,5673,92.0,9904,3217,48,10769,5164,5605
37145,Person County,NC,39345,19087,20258,94.2,2201,2200,2406,2645,1813,4236,4806,5424,2895,3262,4480,2212,765,43.7,8335,31010,14805,16205,91.4,26592,10329,152,30206,14353,15853
37147,Pitt County,NC,178433,83978,94455,88.9,10377,10662,10981,14908,23058,24549,21007,20058,9973,10001,13697,7160,2002,32.5,38413,140020,64213,75807,84.7,102087,61924,3116,135239,61681,73558
37149,Polk County,NC,20557,9719,10838,89.7,681,973,1021,1079,914,1745,1859,2594,1619,1869,3291,2082,830,52.7,3374,17183,8076,9107,88.7,18556,1005,136,16757,7876,8881
37151,Randolph County,NC,143118,70546,72572,97.2,8054,8851,9565,9485,8055,16662,16966,20826,10989,8823,14785,7524,2533,41.7,32691,110427,53846,56581,95.2,119970,8619,1737,104208,50476,53732
37153,Richmond County,NC,44997,22048,22949,96.1,2709,2669,3062,2725,3249,5268,5379,5968,3057,3064,4630,2548,669,40.5,10257,34740,16782,17958,93.5,27785,14344,436,33719,16131,17588
37155,Robeson County,NC,132596,63995,68601,93.3,8947,9497,9314,10039,9250,16789,15886,16615,8379,8368,12161,5418,1933,36.6,33405,99191,46965,52226,89.9,37096,31585,798,95311,44732,50579
37157,Rockingham County,NC,91077,43801,47276,92.6,4734,5290,5203,5315,5064,9787,10533,12894,6969,7175,10492,5523,2098,44.7,18656,72421,34376,38045,90.4,68702,16739,535,70526,33358,37168
37159,Rowan County,NC,140296,69468,70828,98.1,7936,8571,9259,9326,8515,17239,16504,19427,10655,8742,14105,7325,2692,40.2,31440,108856,53229,55627,95.7,107590,22677,1228,104365,50676,53689
37161,Rutherford County,NC,66599,32365,34234,94.5,3407,4005,3588,4442,3288,7253,7300,9363,4838,5032,8351,4141,1591,45.0,13794,52805,25094,27711,90.6,57790,6355,282,52072,24696,27376
37163,Sampson County,NC,63385,31127,32258,96.5,4088,4202,4522,4152,3891,7033,7761,8370,4296,4025,6453,3616,976,40.3,15556,47829,23176,24653,94.0,39791,16080,356,43234,20547,22687
37165,Scotland County,NC,35076,17293,17783,97.2,2235,2369,2247,2167,2444,4254,4250,4305,2284,2412,3624,1756,729,39.3,8046,27030,13189,13841,95.3,15317,13660,284,26571,12910,13661
37167,Stanly County,NC,61588,30696,30892,99.4,3319,3919,3758,3920,3537,7547,7052,8633,4581,3787,6924,3329,1282,42.2,13389,48199,23787,24412,97.4,51502,7000,1104,47134,23237,23897
37169,Stokes County,NC,45781,22256,23525,94.6,1968,2423,2643,2757,2365,4851,5144,6977,3911,3443,5421,2892,986,46.2,8814,36967,17925,19042,94.1,42590,1909,167,36453,17716,18737
37171,Surry County,NC,71971,34908,37063,94.2,3681,4356,4351,4677,3971,7745,8228,10398,5048,5040,8292,4302,1882,44.1,15394,56577,27240,29337,92.9,65358,2683,415,54183,25931,28252
37173,Swain County,NC,14260,6966,7294,95.5,914,963,898,880,812,1666,1579,1860,901,1083,1601,765,338,41.9,3286,10974,5274,5700,92.5,9147,67,54,10763,5081,5682
37175,Transylvania County,NC,33775,16252,17523,92.7,1335,1635,1475,1866,1827,3215,3212,3917,2482,2699,5533,3178,1401,51.1,5406,28369,13452,14917,90.2,30933,1612,47,27745,13085,14660
37177,Tyrrell County,NC,4095,2356,1739,135.5,129,191,196,85,397,519,444,598,337,380,407,349,63,46.2,570,3525,2064,1461,141.3,2268,1521,18,3406,2024,1382
37179,Union County,NC,231053,113824,117229,97.1,13312,16725,20475,19475,13690,22360,31772,37699,15926,11117,17859,7994,2649,38.2,62968,168085,81661,86424,94.5,187754,26454,6989,157443,76186,81257
37181,Vance County,NC,44479,20751,23728,87.5,2762,2564,3398,2900,2793,5212,4795,6000,3040,3065,4734,2390,826,40.9,10614,33865,15410,18455,83.5,18961,22166,319,32350,14529,17821
37183,Wake County,NC,1069079,519794,549285,94.6,66698,72166,75376,74082,67697,157847,160777,153453,66603,54001,75055,32719,12605,36.2,258475,810604,388650,421954,92.1,698759,218151,74284,737397,350515,386882
37185,Warren County,NC,19898,9884,10014,98.7,899,1000,1059,1138,1252,1971,2006,2420,1616,1649,2867,1420,601,48.0,3644,16254,8031,8223,97.7,7900,10004,104,15967,7875,8092
37187,Washington County,NC,11922,5591,6331,88.3,551,737,726,828,905,824,1265,1319,943,1010,1645,918,251,46.1,2418,9504,4305,5199,82.8,5450,5658,26,9357,4178,5179
37189,Watauga County,NC,54925,27313,27612,98.9,1843,2100,1910,7268,10052,5917,5034,5717,3294,3283,5159,2594,754,31.9,7152,47773,23621,24152,97.8,51539,967,651,46865,23113,23752
37191,Wayne County,NC,123603,60358,63245,95.4,8244,7598,8682,7928,9016,16566,14214,15369,7619,8599,11553,6241,1974,37.8,29412,94191,45315,48876,92.7,78721,37666,1488,87826,42179,45647
37193,Wilkes County,NC,68469,33733,34736,97.1,3426,3890,4141,4042,3670,7379,7786,9616,4909,5242,8262,4712,1394,44.9,14094,54375,26515,27860,95.2,62347,2712,398,52699,25542,27157
37195,Wilson County,NC,81435,38537,42898,89.8,4814,5059,5641,5519,4898,9779,9373,10634,5503,5986,8402,4178,1649,40.5,18832,62603,28936,33667,85.9,41323,32275,675,59542,27128,32414
37197,Yadkin County,NC,37602,18625,18977,98.1,1950,2069,2433,2266,2128,3969,4286,5701,2661,2796,4177,2360,806,44.4,7970,29632,14436,15196,95.0,34639,1320,23,28279,13701,14578
37199,Yancey County,NC,17760,8701,9059,96.0,760,894,1015,936,950,1763,1926,2403,1219,1404,2578,1476,436,47.6,3301,14459,6957,7502,92.7,17083,119,50,14088,6796,7292
38001,Adams County,ND,2311,1106,1205,91.8,120,150,148,139,112,220,243,281,127,208,295,146,122,45.6,513,1798,866,932,92.9,2172,48,58,1761,849,912
38003,Barnes County,ND,10706,5325,5381,99.0,504,541,624,699,693,1178,1090,1333,859,843,1245,736,361,45.1,2024,8682,4321,4361,99.1,10046,239,109,8512,4227,4285
38005,Benson County,ND,6873,3522,3351,105.1,736,620,697,493,415,822,639,697,437,403,554,267,93,30.5,2388,4485,2280,2205,103.4,2793,3,4,4475,2280,2195
38007,Billings County,ND,922,516,406,127.1,91,50,35,25,15,117,139,80,92,81,96,52,49,43.7,197,725,395,330,119.7,895,0,0,715,392,323
38009,Bottineau County,ND,6502,3393,3109,109.1,362,352,452,416,381,619,671,727,525,507,850,434,206,45.0,1380,5122,2652,2470,107.4,6048,42,7,5054,2611,2443
38011,Bowman County,ND,3148,1561,1587,98.4,207,289,153,167,202,333,359,298,238,255,320,235,92,41.0,770,2378,1180,1198,98.5,3026,1,0,2358,1169,1189
38013,Burke County,ND,2182,1187,995,119.3,215,150,177,91,51,348,214,245,158,164,205,109,55,36.8,595,1587,842,745,113.0,2099,5,11,1561,837,724
38015,Burleigh County,ND,94793,47528,47265,100.6,6471,6304,5934,5869,6262,13892,11953,10969,6383,5949,8190,4052,2565,37.0,21974,72819,36223,36596,99.0,85927,2140,734,71677,35562,36115
38017,Cass County,ND,176975,89658,87317,102.7,12518,11189,10242,11482,19697,30877,22913,18683,9211,9612,11676,5656,3219,32.5,39615,137360,69371,67989,102.0,154002,9941,5120,130459,65800,64659
38019,Cavalier County,ND,3803,1948,1855,105.0,252,178,258,161,236,324,322,421,328,293,510,352,168,49.5,813,2990,1511,1479,102.2,3609,2,0,2960,1493,1467
38021,Dickey County,ND,4938,2473,2465,100.3,283,331,329,350,320,517,520,599,341,340,478,293,237,41.9,1156,3782,1875,1907,98.3,4769,65,8,3706,1806,1900
38023,Divide County,ND,2335,1111,1224,90.8,84,171,56,187,110,144,259,310,149,245,341,141,138,51.1,461,1874,937,937,100.0,2170,74,29,1846,936,910
38025,Dunn County,ND,4395,2301,2094,109.9,295,262,319,257,211,596,450,526,462,285,399,228,105,39.0,1053,3342,1782,1560,114.2,3731,75,35,3299,1771,1528
38027,Eddy County,ND,2301,1110,1191,93.2,161,108,102,130,142,239,248,288,145,165,268,190,115,45.8,495,1806,856,950,90.1,2097,0,0,1799,851,948
38029,Emmons County,ND,3310,1684,1626,103.6,181,191,178,119,198,305,266,366,287,244,486,329,160,50.9,632,2678,1378,1300,106.0,3182,0,36,2657,1371,1286
38031,Foster County,ND,3260,1599,1661,96.3,184,150,253,220,133,324,380,357,297,228,340,209,185,44.8,697,2563,1283,1280,100.2,3127,0,1,2536,1265,1271
38033,Golden Valley County,ND,1845,909,936,97.1,108,103,110,117,119,176,190,232,173,135,224,96,62,45.0,410,1435,735,700,105.0,1711,0,0,1435,735,700
38035,Grand Forks County,ND,70224,36394,33830,107.6,4790,4049,3774,5500,10712,11463,6950,6699,3831,3826,4929,2405,1296,29.7,14584,55640,28822,26818,107.5,60439,2641,1962,53358,27520,25838
38037,Grant County,ND,2353,1204,1149,104.8,136,137,124,134,77,240,208,228,221,164,334,229,121,50.1,487,1866,969,897,108.0,2271,2,28,1851,963,888
38039,Griggs County,ND,2409,1219,1190,102.4,166,106,141,123,119,209,214,246,159,211,374,211,130,51.1,510,1899,940,959,98.0,2296,0,0,1899,940,959
38041,Hettinger County,ND,2547,1206,1341,89.9,139,189,132,93,84,358,256,276,169,232,308,191,120,46.5,518,2029,955,1074,88.9,2343,10,0,2013,944,1069
38043,Kidder County,ND,2466,1320,1146,115.2,158,144,115,203,66,225,237,328,220,245,255,223,47,47.8,528,1938,1031,907,113.7,2369,5,6,1928,1021,907
38045,LaMoure County,ND,4125,2132,1993,107.0,202,255,279,201,236,363,379,451,345,357,498,386,173,47.9,871,3254,1654,1600,103.4,3981,41,8,3227,1637,1590
38047,Logan County,ND,1872,974,898,108.5,126,109,68,94,95,170,164,211,168,143,244,192,88,52.0,380,1492,769,723,106.4,1833,0,2,1485,765,720
38049,McHenry County,ND,5878,3004,2874,104.5,333,437,379,346,245,634,673,771,370,504,631,397,158,43.2,1397,4481,2292,2189,104.7,5700,21,23,4457,2275,2182
38051,McIntosh County,ND,2597,1311,1286,101.9,126,101,157,92,122,267,198,293,258,172,318,309,184,53.5,451,2146,1049,1097,95.6,2492,14,13,2114,1037,1077
38053,McKenzie County,ND,13334,7266,6068,119.7,1376,1350,906,809,927,2352,1509,1446,850,652,684,365,108,30.1,4212,9122,5019,4103,122.3,11112,216,53,9081,5004,4077
38055,McLean County,ND,9584,4964,4620,107.4,552,636,552,500,394,993,1047,1092,783,841,1285,636,273,46.0,2065,7519,3872,3647,106.2,8620,66,8,7457,3862,3595
38057,Mercer County,ND,8462,4326,4136,104.6,521,497,572,479,407,929,898,1088,780,741,850,498,202,44.0,1911,6551,3369,3182,105.9,7869,73,38,6485,3361,3124
38059,Morton County,ND,30868,15564,15304,101.7,1927,2063,1757,1531,1688,4989,4010,3749,2528,1691,2733,1463,739,37.8,6712,24156,12135,12021,100.9,28149,310,201,23978,12027,11951
38061,Mountrail County,ND,10321,5558,4763,116.7,903,816,652,718,666,1680,1283,1168,759,509,722,263,182,33.2,2789,7532,4175,3357,124.4,6648,146,49,7353,4061,3292
38063,Nelson County,ND,2894,1465,1429,102.5,146,148,146,118,153,297,242,327,245,282,397,227,166,52.4,531,2363,1199,1164,103.0,2794,3,1,2305,1164,1141
38065,Oliver County,ND,1842,944,898,105.1,130,111,150,111,54,161,191,181,161,160,277,125,30,47.0,485,1357,680,677,100.4,1671,0,32,1357,680,677
38067,Pembina County,ND,6947,3631,3316,109.5,389,384,421,321,356,730,708,863,585,627,821,493,249,48.1,1437,5510,2892,2618,110.5,6551,23,37,5406,2828,2578
38069,Pierce County,ND,4126,2043,2083,98.1,270,284,201,163,235,485,383,507,319,297,484,311,187,45.8,880,3246,1599,1647,97.1,3869,25,15,3230,1588,1642
38071,Ramsey County,ND,11583,5908,5675,104.1,735,965,517,796,695,1423,1146,1392,943,749,1184,772,266,40.7,2692,8891,4527,4364,103.7,9764,64,99,8709,4375,4334
38073,Ransom County,ND,5314,2633,2681,98.2,287,319,288,282,319,490,564,785,438,405,572,303,262,46.6,1100,4214,2050,2164,94.7,5067,43,57,4091,2024,2067
38075,Renville County,ND,2442,1238,1204,102.8,218,179,157,93,113,328,242,338,163,186,226,128,71,39.0,606,1836,958,878,109.1,2364,6,5,1825,950,875
38077,Richland County,ND,16254,8507,7747,109.8,910,1015,1004,1477,1297,1877,1713,1734,1203,1219,1441,918,446,37.3,3487,12767,6652,6115,108.8,15120,112,62,12723,6622,6101
38079,Rolette County,ND,14511,7188,7323,98.2,1367,1368,1481,1092,902,1726,1599,1637,964,737,1009,432,197,31.4,4905,9606,4682,4924,95.1,2640,93,21,9580,4661,4919
38081,Sargent County,ND,3872,2059,1813,113.6,202,231,205,180,240,462,407,478,329,280,496,241,121,45.2,764,3108,1672,1436,116.4,3647,96,11,3032,1608,1424
38083,Sheridan County,ND,1409,718,691,103.9,81,68,45,55,71,127,107,215,124,98,194,173,51,50.9,231,1178,608,570,106.7,1393,0,0,1173,608,565
38085,Sioux County,ND,4373,2180,2193,99.4,431,427,451,411,301,598,457,525,251,178,207,126,10,28.2,1572,2801,1401,1400,100.1,581,7,0,2799,1399,1400
38087,Slope County,ND,742,362,380,95.3,32,53,45,29,39,50,88,79,62,68,98,78,21,47.7,148,594,295,299,98.7,715,13,0,592,295,297
38089,Stark County,ND,31081,15927,15154,105.1,2525,2324,2040,1700,2156,5245,3840,3608,2063,1541,2013,1386,640,34.2,8041,23040,11896,11144,106.7,28352,625,387,22457,11603,10854
38091,Steele County,ND,1744,918,826,111.1,76,69,164,62,99,139,158,231,170,170,239,132,35,50.3,342,1402,761,641,118.7,1708,13,0,1402,761,641
38093,Stutsman County,ND,20965,10714,10251,104.5,1195,1257,1058,1312,1543,2765,2314,2373,1518,1668,2108,1084,770,40.5,4196,16769,8609,8160,105.5,19479,309,107,16522,8412,8110
38095,Towner County,ND,2224,1205,1019,118.3,82,151,166,107,99,196,246,286,206,183,233,194,75,47.6,497,1727,944,783,120.6,2052,17,4,1625,873,752
38097,Traill County,ND,8008,4085,3923,104.1,463,525,463,605,510,884,839,1014,534,621,769,477,304,41.2,1781,6227,3179,3048,104.3,7468,87,30,6137,3137,3000
38099,Walsh County,ND,10751,5512,5239,105.2,732,749,565,611,493,1272,1017,1387,966,711,1124,736,388,44.2,2452,8299,4192,4107,102.1,10130,44,51,8061,4061,4000
38101,Ward County,ND,68812,35715,33097,107.9,5306,4899,4029,3956,7076,12651,8280,6997,3831,3371,4470,2761,1185,31.6,16278,52534,27634,24900,111.0,59575,2653,1194,50684,26764,23920
38103,Wells County,ND,3976,1980,1996,99.2,220,358,180,98,194,353,347,442,404,323,508,336,213,51.6,851,3125,1545,1580,97.8,3892,0,9,3121,1544,1577
38105,Williams County,ND,35208,19250,15958,120.6,3191,2753,2577,2001,2336,7317,4376,3653,2105,1694,1727,903,575,31.3,9880,25328,13910,11418,121.8,28778,1572,341,24155,13378,10777
39001,Adams County,OH,27776,13824,13952,99.1,1671,1861,1928,1820,1509,3023,3328,3773,2142,1865,2872,1594,390,42.0,6691,21085,10337,10748,96.2,27455,129,8,21055,10330,10725
39003,Allen County,OH,103175,52045,51130,101.8,6321,6424,6932,7314,7039,12690,12197,12382,7100,7029,10025,5341,2381,39.2,23931,79244,39737,39507,100.6,85161,12230,871,78409,39329,39080
39005,Ashland County,OH,53536,26144,27392,95.4,3036,3444,3387,4277,3905,5822,5724,6732,3660,3730,5458,3235,1126,40.4,12152,41384,20008,21376,93.6,51783,397,352,41065,19846,21219
39007,Ashtabula County,OH,97830,49211,48619,101.2,5502,6190,6060,5954,5516,11345,11022,13513,6850,7746,10557,5370,2205,42.5,21677,76153,38072,38081,100.0,90804,3515,533,75625,37843,37782
39009,Athens County,OH,65917,32827,33090,99.2,2555,2457,2801,9478,11642,8093,6472,6735,3759,3644,5005,2166,1110,29.6,9686,56231,27800,28431,97.8,60024,1962,1728,54264,26672,27592
39011,Auglaize County,OH,45729,22693,23036,98.5,2864,3122,3104,2943,2684,5081,5193,5881,3522,3149,4477,2511,1198,41.1,11061,34668,17115,17553,97.5,44142,292,216,34478,17009,17469
39013,Belmont County,OH,68024,34882,33142,105.3,3333,3312,3899,3580,3588,8462,8174,9197,5084,5565,7812,4159,1859,44.6,12895,55129,28166,26963,104.5,63374,2652,333,54905,28092,26813
39015,Brown County,OH,43572,21681,21891,99.0,2512,2344,3310,2764,2259,4849,5335,5947,3269,3083,4484,2440,976,42.1,10014,33558,16597,16961,97.9,42265,353,124,33450,16526,16924
39017,Butler County,OH,380019,186236,193783,96.1,23176,23711,27080,29673,32952,44596,45862,49307,24548,24507,32321,15683,6603,36.7,89787,290232,140373,149859,93.7,320689,30587,12447,278507,134362,144145
39019,Carroll County,OH,27332,13743,13589,101.1,1364,1518,1725,1665,1409,2768,3029,3696,2344,2128,3340,1714,632,45.5,5707,21625,10788,10837,99.5,27126,72,9,21617,10788,10829
39021,Champaign County,OH,38845,19360,19485,99.4,2082,2130,2853,2601,2327,4371,4479,5502,2866,2603,4142,2167,722,41.9,8721,30124,14823,15301,96.9,36711,712,199,29985,14749,15236
39023,Clark County,OH,134726,65237,69489,93.9,7956,8038,9002,9197,8401,15546,14662,17510,9611,9168,14604,7667,3364,41.1,30418,104308,49669,54639,90.9,116999,10915,825,103100,48976,54124
39025,Clermont County,OH,204275,100551,103724,96.9,11937,13430,13865,12670,11644,25107,25712,28140,15171,14438,19596,9139,3426,40.0,47598,156677,76336,80341,95.0,194339,2895,2550,154742,75238,79504
39027,Clinton County,OH,41957,20750,21207,97.8,2570,2804,2697,2935,2761,4760,4986,5521,3111,2861,4130,2042,779,39.4,9799,32158,15691,16467,95.3,39562,861,200,31853,15513,16340
39029,Columbiana County,OH,103190,52098,51092,102.0,5326,6091,5920,6041,5537,11423,12361,13843,7894,8287,11689,6357,2421,44.1,21187,82003,41239,40764,101.2,97715,2112,191,81595,41042,40553
39031,Coshocton County,OH,36585,18120,18465,98.1,2313,2427,2339,2297,1876,4227,4128,4705,2606,2719,3901,2123,924,41.3,8623,27962,13592,14370,94.6,35436,419,107,27905,13574,14331
39033,Crawford County,OH,41821,20562,21259,96.7,2419,2381,2718,2461,2390,4577,4843,5409,2983,3104,4696,2900,940,43.0,9142,32679,15786,16893,93.4,40391,426,220,32490,15641,16849
39035,Cuyahoga County,OH,1247451,594606,652845,91.1,71770,68572,74659,76086,81130,172607,143264,159361,91419,87216,121934,66360,33073,40.4,261154,986297,461616,524681,88.0,778519,368969,37879,953170,444859,508311
39037,Darke County,OH,51513,25458,26055,97.7,3076,3501,3445,3399,2838,5371,5840,6820,3899,3463,5400,3312,1149,41.9,12304,39209,19187,20022,95.8,50108,385,255,39036,19101,19935
39039,Defiance County,OH,38160,19028,19132,99.5,2221,2258,2651,2691,2435,4317,4722,4570,2614,2736,4021,2003,921,40.4,8794,29366,14431,14935,96.6,34608,670,168,28955,14155,14800
39041,Delaware County,OH,201135,99700,101435,98.3,12459,15270,16329,14843,10500,19686,30741,30552,13132,11136,16540,7267,2680,38.8,53697,147438,72222,75216,96.0,175014,6845,12716,141117,69165,71952
39043,Erie County,OH,74780,36673,38107,96.2,4010,4168,4327,4242,4394,8557,7908,9588,5879,5777,9114,4829,1987,44.8,15298,59482,28791,30691,93.8,63928,6769,441,58936,28506,30430
39045,Fairfield County,OH,154457,76903,77554,99.2,9133,10192,10951,10667,9218,18210,20043,21909,10585,9790,14060,7194,2505,39.2,37226,117231,57791,59440,97.2,134573,11384,2492,115186,56891,58295
39047,Fayette County,OH,28620,13972,14648,95.4,1743,1770,2118,1702,1666,3345,3457,3967,2100,1793,2935,1478,546,41.4,6769,21851,10504,11347,92.6,26802,710,282,21559,10423,11136
39049,Franklin County,OH,1290360,629722,660638,95.3,91985,84191,79617,82098,90884,234833,172282,156266,77408,69385,91721,41060,18630,34.1,301680,988680,476381,512299,93.0,855170,291177,67795,922205,441720,480485
39051,Fulton County,OH,42253,20888,21365,97.8,2485,2631,3091,2899,2449,4610,5011,5541,3068,3171,4208,2142,947,41.1,10038,32215,15607,16608,94.0,39307,169,182,31848,15438,16410
39053,Gallia County,OH,30088,14826,15262,97.1,1922,1854,1990,1865,1782,3598,3325,3877,2271,2038,3097,1874,595,40.7,6921,23167,11249,11918,94.4,28219,657,232,23017,11169,11848
39055,Geauga County,OH,93843,46444,47399,98.0,4939,5581,6797,6724,5437,7921,9739,13468,8093,6563,10742,5684,2155,44.8,21733,72110,35404,36706,96.5,90764,1276,620,71458,34996,36462
39057,Greene County,OH,166502,81988,84514,97.0,9367,9212,9770,12492,13478,22317,18700,20456,11810,10983,16294,8497,3126,38.3,34367,132135,64291,67844,94.8,142871,11516,4892,128712,62698,66014
39059,Guernsey County,OH,39111,19534,19577,99.8,2327,2214,2561,2479,2186,4689,4250,5222,2990,2740,4329,2332,792,42.2,8682,30429,14992,15437,97.1,37144,444,171,30326,14915,15411
39061,Hamilton County,OH,813589,392738,420851,93.3,53603,51767,51949,53219,53671,122931,95657,100308,55311,52722,69762,34829,17860,36.8,187899,625690,297309,328381,90.5,548299,207839,21550,604004,285403,318601
39063,Hancock County,OH,75837,37499,38338,97.8,4566,4690,4759,5144,4732,10286,8784,9772,5445,5036,7063,3929,1631,39.3,16937,58900,28944,29956,96.6,69813,1258,1467,57429,28030,29399
39065,Hardin County,OH,31425,15568,15857,98.2,1884,2126,1961,2794,3484,3196,3479,3720,2088,1795,2844,1324,730,35.9,7278,24147,11774,12373,95.2,30171,230,249,23703,11534,12169
39067,Harrison County,OH,15211,7489,7722,97.0,811,882,880,919,749,1481,1645,2097,1073,1488,1831,1000,355,46.3,3197,12014,5897,6117,96.4,14484,434,75,11948,5870,6078
39069,Henry County,OH,27208,13387,13821,96.9,1594,1865,1771,1755,1437,3145,3258,3496,2038,1949,2608,1588,704,41.1,6396,20812,10222,10590,96.5,25451,252,85,20650,10110,10540
39071,Highland County,OH,43016,21048,21968,95.8,2655,2717,3025,2978,2282,4773,5120,5793,2745,3205,4438,2569,716,40.8,10308,32708,15731,16977,92.7,41178,627,170,32570,15708,16862
39073,Hocking County,OH,28390,13914,14476,96.1,1598,1652,1825,1803,1534,3057,3371,3927,2168,2194,3090,1505,666,43.1,6272,22118,10850,11268,96.3,27545,218,63,22044,10846,11198
39075,Holmes County,OH,43901,21904,21997,99.6,3605,3811,4039,3727,3070,5545,4766,4757,2739,1983,3302,1596,961,31.5,13938,29963,14824,15139,97.9,43219,60,114,29952,14824,15128
39077,Huron County,OH,58339,28847,29492,97.8,3662,3778,4256,3869,3378,6958,6770,7770,4000,4152,5846,2659,1241,39.8,14191,44148,21633,22515,96.1,55797,792,131,43637,21319,22318
39079,Jackson County,OH,32450,15723,16727,94.0,2058,2247,2203,1981,1764,4097,3999,4177,2148,2332,3304,1715,425,40.1,7829,24621,11822,12799,92.4,31403,211,44,24521,11777,12744
39081,Jefferson County,OH,66371,32276,34095,94.7,3324,3207,3980,4164,4413,7108,7147,8645,5036,5397,7946,4396,1608,44.8,12832,53539,25578,27961,91.5,60567,3654,349,53277,25492,27785
39083,Knox County,OH,61481,29878,31603,94.5,3645,4058,3809,4857,4697,6753,6643,7588,4075,4450,6315,3197,1394,39.4,14031,47450,22798,24652,92.5,59292,607,282,47017,22658,24359
39085,Lake County,OH,229954,112407,117547,95.6,11422,12715,13603,13773,12932,27117,26415,31690,18152,17351,25515,13353,5916,43.8,46564,183390,88561,94829,93.4,209296,9947,2838,178680,85698,92982
39087,Lawrence County,OH,60184,29384,30800,95.4,3448,3570,3870,3602,3290,7212,7323,8246,4495,4052,6404,3699,973,41.8,13222,46962,22486,24476,91.9,57458,1211,315,46742,22401,24341
39089,Licking County,OH,173750,85151,88599,96.1,10490,10790,12008,12096,10919,20048,21100,24120,12758,11424,16697,8271,3029,39.7,40449,133301,64388,68913,93.4,158836,6676,2179,131858,63833,68025
39091,Logan County,OH,45316,22395,22921,97.7,2767,2725,3237,2898,2504,5058,5356,6077,3312,3429,4740,2413,800,41.4,10600,34716,16955,17761,95.5,42862,808,372,34411,16832,17579
39093,Lorain County,OH,307670,151471,156199,97.0,17412,18564,19798,20607,18776,34272,37345,42133,22627,21467,31716,15865,7088,41.8,68353,239317,116396,122921,94.7,261580,26255,3578,235870,114601,121269
39095,Lucas County,OH,431102,208922,222180,94.0,27655,27628,27701,27353,28370,60839,49836,54282,30321,28882,39893,19130,9212,37.8,99494,331608,158022,173586,91.0,310784,82120,7440,324770,154345,170425
39097,Madison County,OH,44135,23954,20181,118.7,2216,2666,2653,2390,2559,6051,6248,6749,3180,2709,3873,2151,690,40.8,9073,35062,19356,15706,123.2,39820,2602,310,34571,19178,15393
39099,Mahoning County,OH,229961,112279,117682,95.4,12006,12388,13414,13978,14438,26811,25624,29114,17364,17882,25654,13875,7413,43.5,46394,183567,88435,95132,93.0,183221,34740,2042,182005,87579,94426
39101,Marion County,OH,65299,34643,30656,113.0,3815,3695,3719,3783,3979,8786,8126,8949,4821,4360,6562,3150,1554,41.3,13747,51552,27608,23944,115.3,58505,3714,420,51067,27307,23760
39103,Medina County,OH,177980,88299,89681,98.5,9485,10693,12271,11826,9413,19169,22434,26234,13786,11862,18431,8960,3416,42.2,40262,137718,67379,70339,95.8,169681,2675,1997,136418,66863,69555
39105,Meigs County,OH,23078,11549,11529,100.2,1159,1266,1571,1465,1101,2554,2811,3142,1838,1722,2631,1303,515,43.6,4982,18096,8949,9147,97.8,22417,256,1,18060,8914,9146
39107,Mercer County,OH,40884,20670,20214,102.3,2905,2692,3186,2745,2351,4576,4380,5028,3051,2896,3921,2270,883,39.6,10523,30361,15215,15146,100.5,39658,335,228,30001,15019,14982
39109,Miami County,OH,105371,52106,53265,97.8,6153,6606,7207,6808,5537,12242,12756,13955,7414,7341,11204,5815,2333,41.3,24396,80975,39476,41499,95.1,98717,2130,1317,80195,39185,41010
39111,Monroe County,OH,13942,6931,7011,98.9,698,854,804,818,659,1389,1519,1861,1123,974,1843,1110,290,46.5,2919,11023,5474,5549,98.6,13694,53,65,11009,5473,5536
39113,Montgomery County,OH,531670,255887,275783,92.8,32677,31927,33068,33854,35591,71706,60504,66660,36829,35130,52410,28847,12467,39.2,117996,413674,195462,218212,89.6,386350,108397,11476,402194,189521,212673
39115,Morgan County,OH,14640,7320,7320,100.0,711,880,910,913,763,1557,1688,1907,1198,1076,1679,1066,292,44.5,3093,11547,5705,5842,97.7,13538,721,30,11523,5693,5830
39117,Morrow County,OH,35043,17570,17473,100.6,1889,1966,2618,2562,1821,3685,4244,4975,2661,2813,3415,1825,569,42.2,8135,26908,13376,13532,98.8,33794,312,40,26853,13374,13479
39119,Muskingum County,OH,86131,41716,44415,93.9,5212,5372,5621,5616,5655,10258,10098,11275,6442,5545,8546,4516,1975,40.3,19718,66413,31700,34713,91.3,79042,2779,385,66039,31565,34474
39121,Noble County,OH,14416,8631,5785,149.2,704,860,655,652,475,1850,1365,1195,1397,1418,2341,1021,483,50.4,2666,11750,7281,4469,162.9,13355,807,11,11682,7213,4469
39123,Ottawa County,OH,40632,20162,20470,98.5,1700,1988,2385,2304,1868,3728,4302,5312,3500,3619,5805,2894,1227,49.3,7624,33008,16280,16728,97.3,38754,497,87,32876,16203,16673
39125,Paulding County,OH,18809,9413,9396,100.2,1084,1333,1281,1149,988,2148,2131,2493,1421,1367,1999,1052,363,42.1,4458,14351,7149,7202,99.3,17951,147,41,14205,7061,7144
39127,Perry County,OH,36022,18001,18021,99.9,2170,2238,2544,2385,2013,4207,4392,5083,2376,2768,3656,1660,530,40.2,8530,27492,13655,13837,98.7,35009,139,48,27453,13636,13817
39129,Pickaway County,OH,57762,30389,27373,111.0,3073,3287,3722,3839,3590,7563,7884,8395,4156,3302,5235,2838,878,39.7,12516,45246,24111,21135,114.1,53851,2055,372,44996,23968,21028
39131,Pike County,OH,28000,13818,14182,97.4,1624,1849,1754,1834,1538,3307,3367,3745,1867,2200,2842,1561,512,40.8,6501,21499,10465,11034,94.8,26742,468,23,21434,10465,10969
39133,Portage County,OH,162511,79755,82756,96.4,7497,8427,8811,14062,18403,18435,17141,21058,12086,10760,15350,7567,2914,38.0,30694,131817,64009,67808,94.4,147306,6724,2907,128313,62282,66031
39135,Preble County,OH,41093,20388,20705,98.5,2280,2337,2895,2679,2100,4546,4833,5532,3491,2707,4558,2323,812,42.7,9277,31816,15579,16237,95.9,39820,215,182,31655,15543,16112
39137,Putnam County,OH,33911,16944,16967,99.9,2271,2573,2433,2098,1955,3718,3820,4346,2577,2398,3125,1762,835,39.8,8656,25255,12554,12701,98.8,31974,137,53,25050,12416,12634
39139,Richland County,OH,121100,61468,59632,103.1,6926,6724,8014,7277,7510,15000,14362,15235,8689,8132,12729,7126,3376,41.1,26262,94838,48068,46770,102.8,104983,10808,959,94141,47692,46449
39141,Ross County,OH,76948,40332,36616,110.1,4186,4632,4698,4507,4411,9801,10169,11193,5924,5038,7248,3944,1197,41.0,16541,60407,31778,28629,111.0,69541,4050,392,60064,31648,28416
39143,Sandusky County,OH,59029,29301,29728,98.6,3299,3593,4015,3917,3208,6543,7068,7778,4674,4037,6171,3462,1264,42.2,13394,45635,22237,23398,95.0,53834,1766,223,45251,22031,23220
39145,Scioto County,OH,76040,37322,38718,96.4,4384,4557,4666,5011,4585,9900,9232,9732,5593,4854,7564,4542,1420,39.9,16590,59450,28939,30511,94.8,71545,2224,321,59191,28766,30425
39147,Seneca County,OH,55351,27623,27728,99.6,2975,3278,3631,4425,3822,6364,6398,6811,3887,4085,5480,2690,1505,39.9,12188,43163,21270,21893,97.2,51886,1716,344,42563,20893,21670
39149,Shelby County,OH,48749,24594,24155,101.8,3188,3265,3590,3420,2934,5544,5757,6452,3492,3308,4575,2258,966,39.5,12256,36493,18153,18340,99.0,45876,1276,576,36121,17989,18132
39151,Stark County,OH,372404,181002,191402,94.6,20940,21260,23560,23902,22976,43934,42283,48832,27062,26916,39805,21201,9733,42.1,80421,291983,139675,152308,91.7,326746,27880,3432,288886,138042,150844
39153,Summit County,OH,541334,262595,278739,94.2,30403,30404,32802,33604,33862,71561,63082,72498,40011,38505,54370,26720,13512,41.0,114245,427089,204445,222644,91.8,425243,78751,18430,414872,198048,216824
39155,Trumbull County,OH,200367,97661,102706,95.1,10591,11262,11738,11892,11512,22593,22178,26140,15301,15037,23972,12409,5742,44.3,41328,159039,76571,82468,92.8,177380,16468,1047,158330,76279,82051
39157,Tuscarawas County,OH,92335,45476,46859,97.0,5767,5591,5943,5754,5237,10735,10784,11579,7124,6067,9909,5341,2504,41.0,21100,71235,34714,36521,95.1,89194,661,370,70322,34127,36195
39159,Union County,OH,56707,27323,29384,93.0,3490,3850,4030,3844,3272,7268,8679,8551,3790,3134,4180,1808,811,38.0,13989,42718,20108,22610,88.9,51608,1470,2269,41601,19512,22089
39161,Van Wert County,OH,28261,13936,14325,97.3,1736,1862,1826,1805,1627,3162,3295,3646,2162,1910,2895,1691,644,41.2,6620,21641,10583,11058,95.7,27219,371,81,21552,10514,11038
39163,Vinton County,OH,13083,6597,6486,101.7,748,646,1023,772,744,1438,1632,1796,1119,939,1360,652,214,42.9,2959,10124,5078,5046,100.6,12716,34,23,10099,5056,5043
39165,Warren County,OH,229132,115491,113641,101.6,13215,14765,18300,16233,12380,26145,31366,34484,16294,13915,19063,9188,3784,39.4,57189,171943,85973,85970,100.0,202506,7895,13183,165581,82876,82705
39167,Washington County,OH,60426,29883,30543,97.8,2961,2831,3919,3654,3768,6838,6798,7907,4743,4631,6862,4036,1478,44.3,11888,48538,23781,24757,96.1,57903,781,387,48064,23431,24633
39169,Wayne County,OH,116099,57717,58382,98.9,7737,7671,7930,8529,7895,13424,12845,14146,7829,7982,11287,6141,2683,38.7,28315,87784,42949,44835,95.8,109717,1584,1211,86626,42299,44327
39171,Williams County,OH,36816,18267,18549,98.5,2125,2250,2448,2337,2035,4384,4324,4597,2768,2749,3687,2281,831,41.4,8359,28457,14100,14357,98.2,34946,404,214,28258,13990,14268
39173,Wood County,OH,130150,64210,65940,97.4,6899,7627,7362,11550,15894,15865,14410,15059,8440,7755,11349,5779,2161,34.9,26591,103559,50429,53130,94.9,119595,3416,2180,101385,49006,52379
39175,Wyandot County,OH,22000,10835,11165,97.0,1239,1458,1458,1382,1243,2413,2615,2901,1635,1526,2235,1339,556,42.1,5073,16927,8224,8703,94.5,21372,36,183,16738,8122,8616
40001,Adair County,OK,22220,11053,11167,99.0,1622,1677,1714,1536,1354,2648,2677,2833,1422,1349,2038,1082,268,37.2,6000,16220,8019,8201,97.8,9360,36,178,15984,7880,8104
40003,Alfalfa County,OK,5847,3531,2316,152.5,312,297,337,270,260,579,948,864,468,391,580,353,188,44.2,1123,4724,2942,1782,165.1,4986,181,0,4610,2839,1771
40005,Atoka County,OK,13823,7289,6534,111.6,795,886,863,848,790,1838,1686,1637,1001,891,1492,857,239,40.2,3103,10720,5686,5034,113.0,10049,495,99,10612,5622,4990
40007,Beaver County,OK,5377,2703,2674,101.1,314,393,444,333,339,573,623,620,384,348,578,292,136,39.0,1407,3970,2004,1966,101.9,4335,31,2,3561,1743,1818
40009,Beckham County,OK,22268,12115,10153,119.3,1590,1343,1781,1419,1363,3336,2900,2744,1335,1447,1687,968,355,35.9,5564,16704,9298,7406,125.5,18816,944,76,16188,8992,7196
40011,Blaine County,OK,9556,5091,4465,114.0,518,612,524,464,413,1279,1194,1328,853,641,948,576,206,43.5,1965,7591,4061,3530,115.0,7608,399,2,6845,3364,3481
40013,Bryan County,OK,46457,22558,23899,94.4,3016,3061,3002,3179,3134,6529,5282,5528,2846,2676,4771,2577,856,37.2,10916,35541,17144,18397,93.2,34348,817,286,34863,16760,18103
40015,Caddo County,OK,29242,15363,13879,110.7,2018,2001,2079,1964,1590,3702,3718,3696,1904,1802,2686,1630,452,37.7,7365,21877,11577,10300,112.4,18618,668,79,20473,10377,10096
40017,Canadian County,OK,140455,69761,70694,98.7,9580,10733,10348,9220,7608,20675,20424,17372,8442,7928,11174,4935,2016,35.9,36734,103721,51117,52604,97.2,113820,3995,4168,101225,49881,51344
40019,Carter County,OK,48319,23642,24677,95.8,3294,3216,3561,3228,2780,6172,5993,5797,3210,3139,4498,2395,1036,38.2,12159,36160,17370,18790,92.4,36059,3141,598,35209,16789,18420
40021,Cherokee County,OK,48664,23831,24833,96.0,2891,3008,3101,3755,5474,5878,5493,5344,2953,2829,4728,2543,667,35.3,10839,37825,18399,19426,94.7,24777,661,359,36536,17724,18812
40023,Choctaw County,OK,14807,7094,7713,92.0,1000,926,1112,860,764,1642,1583,1787,1026,1102,1710,974,321,42.0,3595,11212,5294,5918,89.5,9300,1631,13,11105,5214,5891
40025,Cimarron County,OK,2174,1065,1109,96.0,146,158,163,93,55,302,205,250,141,132,288,184,57,43.8,557,1617,791,826,95.8,2134,4,6,1504,744,760
40027,Cleveland County,OK,279274,139416,139858,99.7,15187,17039,17716,20752,30703,41589,36224,32002,17058,14732,22050,10317,3905,34.2,60601,218673,108331,110342,98.2,216953,13123,12443,210554,104265,106289
40029,Coal County,OK,5581,2813,2768,101.6,367,343,421,362,345,525,635,621,395,418,633,374,142,42.0,1374,4207,2058,2149,95.8,3909,11,24,4181,2034,2147
40031,Comanche County,OK,121762,63105,58657,107.6,8547,8155,7754,8954,11023,20202,15237,13253,7212,6515,8443,4665,1802,33.0,28880,92882,48439,44443,109.0,76207,20396,3109,90078,47249,42829
40033,Cotton County,OK,5858,2962,2896,102.3,278,327,481,446,357,577,645,747,427,435,651,377,110,43.5,1337,4521,2229,2292,97.3,4695,133,0,4508,2218,2290
40035,Craig County,OK,14390,7352,7038,104.5,797,907,922,874,795,1786,1665,1866,1037,922,1540,901,378,42.1,3174,11216,5766,5450,105.8,9425,451,119,11065,5650,5415
40037,Creek County,OK,71427,35298,36129,97.7,4463,4512,5094,4616,4071,8527,8480,9367,5107,4760,7255,3816,1359,40.3,17062,54365,26568,27797,95.6,56527,1533,310,53569,26135,27434
40039,Custer County,OK,29152,14290,14862,96.2,2131,2367,1689,2400,3593,3673,3159,3035,1429,1763,2141,1063,709,31.4,7364,21788,10726,11062,97.0,23391,903,352,20503,10012,10491
40041,Delaware County,OK,42433,20908,21525,97.1,2168,2398,2528,2520,2165,4271,4369,5183,3181,3302,6193,3230,925,46.7,8690,33743,16474,17269,95.4,27710,199,520,33266,16192,17074
40043,Dewey County,OK,4922,2435,2487,97.9,323,424,377,398,176,547,548,566,335,312,491,312,113,39.2,1351,3571,1765,1806,97.7,4385,8,6,3500,1728,1772
40045,Ellis County,OK,4015,1930,2085,92.6,242,266,272,252,169,391,460,509,321,229,513,284,107,44.1,931,3084,1505,1579,95.3,3692,7,27,3040,1472,1568
40047,Garfield County,OK,61898,30940,30958,99.9,4432,4041,4622,3897,4352,8702,7568,6721,4067,3635,5391,3103,1367,35.8,15574,46324,23003,23321,98.6,50726,1497,558,43245,21512,21733
40049,Garvin County,OK,27835,13796,14039,98.3,1868,1861,2018,1944,1493,3362,3410,3253,1804,1891,2745,1615,571,39.3,6994,20841,10160,10681,95.1,23160,637,85,20325,9861,10464
40051,Grady County,OK,55071,27629,27442,100.7,3190,3449,4277,4020,2899,6483,7100,7222,4220,3465,5294,2416,1036,39.2,13298,41773,20609,21164,97.4,47267,1295,283,41156,20261,20895
40053,Grant County,OK,4397,2212,2185,101.2,244,326,301,311,213,471,431,486,353,333,469,323,136,42.6,1074,3323,1681,1642,102.4,3978,41,8,3305,1673,1632
40055,Greer County,OK,5861,3431,2430,141.2,314,373,308,302,357,954,706,797,455,270,501,275,249,40.4,1191,4670,2820,1850,152.4,4613,380,0,4626,2786,1840
40057,Harmon County,OK,2710,1327,1383,96.0,110,266,182,148,106,306,359,339,181,205,311,127,70,40.6,656,2054,989,1065,92.9,1757,254,20,1968,924,1044
40059,Harper County,OK,3760,1856,1904,97.5,252,328,238,263,117,429,552,341,212,324,342,241,121,39.7,975,2785,1401,1384,101.2,3473,1,0,2451,1199,1252
40061,Haskell County,OK,12687,6285,6402,98.2,807,774,927,833,676,1418,1503,1538,845,851,1464,783,268,41.0,3059,9628,4684,4944,94.7,9179,108,90,9487,4573,4914
40063,Hughes County,OK,13372,7120,6252,113.9,754,777,873,796,882,1848,1654,1629,822,822,1379,779,357,39.4,2953,10419,5589,4830,115.7,8960,761,18,10307,5520,4787
40065,Jackson County,OK,25063,12558,12505,100.4,1961,1806,1619,1588,2024,3743,3155,2573,1589,1288,2138,1177,402,34.1,6363,18700,9293,9407,98.8,18005,1716,331,17912,8960,8952
40067,Jefferson County,OK,6158,3102,3056,101.5,405,406,436,419,270,695,679,700,417,496,704,384,147,41.5,1500,4658,2336,2322,100.6,5224,85,1,4601,2294,2307
40069,Johnston County,OK,11064,5452,5612,97.1,672,767,754,756,664,1248,1192,1374,806,716,1204,633,278,40.1,2617,8447,4130,4317,95.7,7947,207,10,8370,4082,4288
40071,Kay County,OK,44402,22077,22325,98.9,2961,2907,3392,2960,2681,5379,5059,4934,2742,3017,4578,2746,1046,38.4,11092,33310,16342,16968,96.3,34574,915,199,32699,16018,16681
40073,Kingfisher County,OK,15694,7865,7829,100.5,1079,1214,1261,1074,893,1972,1807,1917,1075,957,1362,773,310,37.7,4241,11453,5686,5767,98.6,13364,200,60,10523,5153,5370
40075,Kiowa County,OK,8886,4440,4446,99.9,545,626,581,534,431,970,1006,1102,539,823,975,590,164,42.9,2107,6779,3363,3416,98.4,7078,302,57,6658,3296,3362
40077,Latimer County,OK,10348,5260,5088,103.4,588,558,669,819,675,1141,1077,1264,664,706,1126,821,240,41.3,2238,8110,4082,4028,101.3,6866,113,95,8055,4058,3997
40079,Le Flore County,OK,50026,25079,24947,100.5,3206,3348,3557,3279,2856,6027,6148,6229,3477,3127,5223,2682,867,39.4,12176,37850,18823,19027,98.9,37793,952,347,36712,18134,18578
40081,Lincoln County,OK,34895,17381,17514,99.2,2088,2483,2404,2363,1798,3889,3956,4632,2622,2405,3667,2066,522,41.2,8477,26418,13042,13376,97.5,29620,677,114,26191,12908,13283
40083,Logan County,OK,46683,23132,23551,98.2,2778,2907,3237,3585,3404,5411,5880,5777,3264,3408,4314,2067,651,38.5,10874,35809,17498,18311,95.6,38746,3834,174,34922,17227,17695
40085,Love County,OK,10063,5024,5039,99.7,629,664,767,725,546,1223,1100,1199,633,631,1153,591,202,39.4,2486,7577,3789,3788,100.0,8402,263,82,7266,3612,3654
40087,McClain County,OK,39247,19461,19786,98.4,2304,3121,2892,2666,2131,4595,5322,5071,3009,2167,3581,1886,502,38.5,10077,29170,14247,14923,95.5,33221,464,114,28421,13854,14567
40089,McCurtain County,OK,33016,16326,16690,97.8,2346,2286,2405,2132,1981,4035,3654,4109,2212,2014,3322,1974,546,38.8,8406,24610,11981,12629,94.9,21022,2599,274,24052,11673,12379
40091,McIntosh County,OK,19725,9749,9976,97.7,1022,1082,1121,1033,1033,1980,1991,2363,1388,1747,2808,1590,567,47.8,3974,15751,7665,8086,94.8,13768,528,22,15674,7620,8054
40093,Major County,OK,7692,3804,3888,97.8,513,649,519,471,343,786,907,879,566,542,789,500,228,41.1,1978,5714,2804,2910,96.4,6865,32,67,5495,2680,2815
40095,Marshall County,OK,16505,8173,8332,98.1,955,1003,1215,1040,955,1624,1792,2005,1171,1072,2031,1317,325,42.8,3853,12652,6226,6426,96.9,11591,283,34,11695,5685,6010
40097,Mayes County,OK,41044,20458,20586,99.4,2453,2868,2606,2738,2411,4801,4765,5204,2874,2860,4409,2244,811,40.6,9684,31360,15448,15912,97.1,27301,221,177,31085,15347,15738
40099,Murray County,OK,13946,7021,6925,101.4,834,822,1014,822,762,1622,1614,1805,1068,909,1552,777,345,42.9,3255,10691,5273,5418,97.3,10582,221,86,10455,5156,5299
40101,Muskogee County,OK,68736,33515,35221,95.2,4580,4787,4679,4642,4413,8805,8395,8181,4509,4448,6479,3372,1446,37.9,16826,51910,24930,26980,92.4,39748,7262,475,50841,24331,26510
40103,Noble County,OK,11335,5601,5734,97.7,711,828,786,657,626,1348,1256,1401,850,737,1207,627,301,41.2,2766,8569,4202,4367,96.2,9392,30,9,8512,4200,4312
40105,Nowata County,OK,10322,5091,5231,97.3,614,730,625,625,545,1195,1180,1341,772,717,1073,719,186,42.4,2374,7948,3882,4066,95.5,7007,253,15,7866,3827,4039
40107,Okfuskee County,OK,12067,6487,5580,116.3,685,840,811,706,745,1517,1469,1620,852,707,1207,673,235,40.2,2781,9286,5063,4223,119.9,7657,895,0,9197,5010,4187
40109,Oklahoma County,OK,787216,385353,401863,95.9,59490,55616,55748,49493,52947,124082,100744,90678,48665,44626,62052,30232,12843,34.6,201456,585760,282581,303179,93.2,539029,117836,26573,536721,255963,280758
40111,Okmulgee County,OK,38749,19163,19586,97.8,2386,2469,2737,2787,2621,4608,4226,4655,2678,2531,3952,2390,709,39.0,9220,29529,14315,15214,94.1,25073,3168,169,29271,14228,15043
40113,Osage County,OK,47226,23662,23564,100.4,2407,2865,3215,3079,2495,5412,5442,6085,3919,3203,5411,2856,837,42.5,10443,36783,18360,18423,99.7,30589,5266,204,36595,18302,18293
40115,Ottawa County,OK,31454,15456,15998,96.6,2159,2153,2214,2381,2048,3672,3520,3705,1914,2026,3195,1817,650,38.0,7849,23605,11362,12243,92.8,21248,351,232,23171,11148,12023
40117,Pawnee County,OK,16412,8225,8187,100.5,946,1019,1235,1078,852,1768,1914,2173,1093,1241,1801,971,321,41.9,3903,12509,6174,6335,97.5,12891,169,60,12464,6153,6311
40119,Payne County,OK,81815,41976,39839,105.4,4355,4454,4338,8126,16532,11288,8031,7071,3850,3708,5625,3199,1238,27.3,15653,66162,33713,32449,103.9,65946,3251,3523,61781,31169,30612
40121,Pittsburg County,OK,44146,22433,21713,103.3,2603,2884,2700,2453,2459,5984,5245,5308,3094,2809,4824,2683,1100,40.3,9814,34332,17437,16895,103.2,32189,1261,153,33705,17018,16687
40123,Pontotoc County,OK,38355,18832,19523,96.5,2530,2426,2586,2753,3163,5441,4380,4275,2211,2318,3460,2117,695,35.7,8999,29356,14211,15145,93.8,26364,972,298,28880,13989,14891
40125,Pottawatomie County,OK,72154,34523,37631,91.7,4467,4820,4907,5265,4869,9134,9016,8998,4717,4413,6817,3439,1292,37.7,17252,54902,25728,29174,88.2,54752,2505,472,54361,25432,28929
40127,Pushmataha County,OK,11128,5436,5692,95.5,637,641,779,689,513,1216,1137,1403,818,782,1416,855,242,44.5,2469,8659,4168,4491,92.8,8170,84,41,8629,4146,4483
40129,Roger Mills County,OK,3667,1800,1867,96.4,232,262,309,194,195,385,405,445,320,180,418,237,85,40.6,937,2730,1326,1404,94.4,3232,9,0,2691,1319,1372
40131,Rogers County,OK,91353,45473,45880,99.1,5329,5758,6529,6318,5801,11246,11126,12323,6197,6169,8597,4433,1527,39.1,21709,69644,34297,35347,97.0,68194,940,1309,68487,33744,34743
40133,Seminole County,OK,24832,12172,12660,96.1,1631,1597,1861,1867,1503,2754,2887,3068,1652,1619,2479,1358,556,38.8,6217,18615,8991,9624,93.4,16894,1195,140,18330,8842,9488
40135,Sequoyah County,OK,41709,20574,21135,97.3,2653,2491,2960,2754,2447,4934,4786,5659,3122,2368,4477,2392,666,40.8,9886,31823,15446,16377,94.3,26776,813,340,31441,15204,16237
40137,Stephens County,OK,43647,21168,22479,94.2,2575,2898,2861,2835,2256,5148,5299,5183,3148,3078,4637,2575,1154,40.7,10167,33480,16041,17439,92.0,35971,766,239,32917,15781,17136
40139,Texas County,OK,20805,11095,9710,114.3,1764,1625,1636,1613,1525,2994,2411,2702,1149,1106,1378,687,215,33.0,5976,14829,8031,6798,118.1,13182,514,691,10700,5561,5139
40141,Tillman County,OK,7413,3782,3631,104.2,423,519,506,529,417,713,729,1101,527,495,791,463,200,42.7,1757,5656,2883,2773,104.0,4846,562,16,5306,2705,2601
40143,Tulsa County,OK,646419,315509,330910,95.3,46400,45147,45722,42027,42238,95442,83053,78093,40630,37172,52898,26252,11345,35.7,163646,482773,231725,251048,92.3,452799,65036,21724,448485,212953,235532
40145,Wagoner County,OK,78958,39025,39933,97.7,4769,5466,5699,5249,4187,9926,10434,10238,5328,5010,7782,3940,930,38.8,19346,59612,29174,30438,95.8,59476,2777,1148,58114,28440,29674
40147,Washington County,OK,51886,25270,26616,94.9,3269,3494,3538,3263,2855,6511,5780,6208,3380,3599,5211,3458,1320,40.2,12346,39540,18926,20614,91.8,39881,1406,1156,38247,18238,20009
40149,Washita County,OK,11225,5622,5603,100.3,738,800,799,766,579,1346,1295,1299,853,776,1045,656,273,39.1,2820,8405,4122,4283,96.2,10032,142,8,8262,3998,4264
40151,Woods County,OK,9043,4767,4276,111.5,558,529,489,688,1165,1333,940,830,454,550,739,455,313,33.4,1859,7184,3837,3347,114.6,8005,276,106,7151,3827,3324
40153,Woodward County,OK,20727,10955,9772,112.1,1496,1639,1291,1258,1284,2854,2872,2361,1285,1279,1690,1120,298,36.5,5230,15497,8289,7208,115.0,18541,264,56,14531,7854,6677
41001,Baker County,OR,16019,8257,7762,106.4,790,995,817,710,733,1859,1700,1745,1261,1258,2379,1256,516,48.0,3134,12885,6600,6285,105.0,14844,147,109,12680,6499,6181
41003,Benton County,OR,91107,45794,45313,101.1,3673,3667,4738,8710,14960,12049,9150,9123,5476,5416,8619,3854,1672,33.0,14914,76193,38250,37943,100.8,77177,982,6528,70234,34753,35481
41005,Clackamas County,OR,410463,202194,208269,97.1,22018,24420,26260,25076,22468,50224,53696,55709,28462,30005,44224,19753,8148,41.5,89020,321443,156664,164779,95.1,359191,3865,17543,308705,150064,158641
41007,Clatsop County,OR,39102,19457,19645,99.0,2014,1766,2365,2207,2275,4594,4654,4572,2927,3341,5355,2242,790,44.2,7460,31642,15575,16067,96.9,35929,314,387,30762,15148,15614
41009,Columbia County,OR,51375,25820,25555,101.0,2700,3484,2669,3219,2547,5865,6276,7199,3564,4458,5824,2523,1047,43.3,11002,40373,20127,20246,99.4,47618,248,509,39770,19797,19973
41011,Coos County,OR,63686,31494,32192,97.8,3159,2975,3538,3510,2925,6768,6675,7506,4522,5885,9477,5038,1708,48.6,11787,51899,25318,26581,95.2,56319,327,652,50911,24774,26137
41013,Crook County,OR,23011,11347,11664,97.3,1175,1303,1207,1256,946,2429,2629,2654,1746,1953,3591,1797,325,47.5,4559,18452,9047,9405,96.2,21410,126,80,18156,8963,9193
41015,Curry County,OR,22650,11173,11477,97.4,933,939,905,700,869,1913,2187,2432,1869,2280,4494,2062,1067,56.3,3299,19351,9554,9797,97.5,20583,99,118,19114,9456,9658
41017,Deschutes County,OR,186251,91931,94320,97.5,9554,10979,10736,10191,9176,24263,24597,23617,12732,13956,23278,9691,3481,42.4,37880,148371,72492,75879,95.5,173615,1188,2067,144268,70405,73863
41019,Douglas County,OR,109114,53868,55246,97.5,5647,5638,6109,5865,5286,12005,11310,12780,7790,9134,15883,8492,3175,47.1,21162,87952,42969,44983,95.5,100807,462,1078,86706,42406,44300
41021,Gilliam County,OR,1878,897,981,91.4,74,125,101,82,72,178,180,289,110,192,278,134,63,50.1,373,1505,718,787,91.2,1725,0,15,1479,705,774
41023,Grant County,OR,7189,3671,3518,104.3,330,449,261,342,275,670,710,790,517,746,1164,708,227,52.9,1286,5903,2996,2907,103.1,6811,7,55,5841,2963,2878
41025,Harney County,OR,7267,3736,3531,105.8,382,493,350,385,334,756,866,867,442,656,997,591,148,45.9,1499,5768,2913,2855,102.0,6654,35,0,5703,2867,2836
41027,Hood River County,OR,23209,11598,11611,99.9,1449,1371,1748,1537,1340,2781,3113,3171,1472,1618,2139,1013,457,39.3,5597,17612,8778,8834,99.4,20679,136,383,15025,7335,7690
41029,Jackson County,OR,216574,105742,110832,95.4,11911,12744,12731,12148,12011,27246,25115,25249,14743,16021,27728,12985,5942,42.6,44809,171765,82831,88934,93.1,197752,1486,2837,164781,79476,85305
41031,Jefferson County,OR,23607,12222,11385,107.4,1477,1555,1637,1306,1435,2910,2580,2979,1496,1686,2864,1183,499,40.8,5558,18049,9350,8699,107.5,16713,182,146,17283,8879,8404
41033,Josephine County,OR,86251,42293,43958,96.2,4246,4767,4933,4529,3974,8904,9015,10277,6332,7129,12952,6953,2240,47.7,16895,69356,33409,35947,92.9,79658,442,866,67648,32565,35083
41035,Klamath County,OR,66921,33404,33517,99.7,4101,4202,3812,3946,3922,8380,7194,7843,4593,5079,8465,3870,1514,42.2,14524,52397,26004,26393,98.5,58240,483,682,50532,25066,25466
41037,Lake County,OR,7837,4194,3643,115.1,377,430,393,332,412,828,824,1002,679,631,1174,529,226,48.6,1477,6360,3458,2902,119.2,7193,27,85,6204,3396,2808
41039,Lane County,OR,373340,183845,189495,97.0,18423,18932,19805,24349,35458,48536,44591,42575,24540,25948,42442,19475,8266,39.4,69433,303907,148118,155789,95.1,323102,4064,10127,292396,142204,150192
41041,Lincoln County,OR,48547,23393,25154,93.0,2175,2494,2157,2116,2134,4718,4773,5646,3869,4931,8623,3626,1285,51.6,8210,40337,19207,21130,90.9,42835,271,603,38940,18468,20472
41043,Linn County,OR,125048,61638,63410,97.2,7491,8061,7849,7544,7253,16694,14895,15286,8703,8377,13658,6464,2773,39.6,28410,96638,47152,49486,95.3,112036,627,1344,93445,45522,47923
41045,Malheur County,OR,30412,16551,13861,119.4,2061,2198,2224,2014,2150,4163,3633,3434,1703,1831,2923,1373,705,36.1,7716,22696,12720,9976,127.5,27291,345,430,20574,11353,9221
41047,Marion County,OR,339641,169275,170366,99.4,22652,23052,24603,22990,22516,46981,42955,40515,19910,21374,30851,15066,6176,36.6,84244,255397,125989,129408,97.4,275985,4194,6999,228533,111959,116574
41049,Morrow County,OR,11303,5720,5583,102.5,846,766,943,824,750,1146,1378,1317,738,831,1122,432,210,38.9,3113,8190,4124,4066,101.4,10131,30,70,6803,3368,3435
41051,Multnomah County,OR,804606,398513,406093,98.1,44182,43877,41013,40155,48089,151207,131808,105536,47238,46602,66020,26402,12477,37.2,153081,651525,320104,331421,96.6,627124,43988,59715,599936,293989,305947
41053,Polk County,OR,83037,40552,42485,95.5,4698,5298,5514,6414,7660,9812,9615,9321,4828,5308,8536,3998,2035,37.0,18935,64102,30896,33206,93.0,73159,686,1542,60394,28947,31447
41055,Sherman County,OR,1642,882,760,116.1,60,88,74,110,59,152,198,176,175,122,219,181,28,51.4,277,1365,731,634,115.3,1504,3,2,1352,727,625
41057,Tillamook County,OR,26389,13237,13152,100.6,1222,1531,1545,1160,1192,2883,2720,3106,1990,2480,4062,1648,850,48.1,5033,21356,10636,10720,99.2,24561,110,181,20423,10171,10252
41059,Umatilla County,OR,77129,40155,36974,108.6,5186,5382,5751,5215,5051,10650,9674,9210,4714,4476,6940,3449,1431,36.5,19618,57511,30249,27262,111.0,66148,740,800,52267,27468,24799
41061,Union County,OR,26337,13083,13254,98.7,1530,1642,1594,1891,2141,2965,2957,2739,1738,1857,2980,1720,583,40.2,5800,20537,10055,10482,95.9,24158,198,297,20080,9810,10270
41063,Wallowa County,OR,7004,3444,3560,96.7,342,371,372,244,189,774,668,748,638,680,1135,653,190,52.6,1283,5721,2783,2938,94.7,6647,12,18,5660,2772,2888
41065,Wasco County,OR,26130,13122,13008,100.9,1654,1633,1665,1407,1472,3269,3136,2879,1897,1845,3127,1404,742,40.8,5868,20262,10035,10227,98.1,23029,80,238,18694,9186,9508
41067,Washington County,OR,589481,291701,297780,98.0,35971,38528,39278,35820,35499,92409,88671,78489,35289,33166,46500,20241,9620,36.7,136892,452589,221515,231074,95.9,447201,11897,62545,401003,194977,206026
41069,Wheeler County,OR,1415,713,702,101.6,103,58,53,37,68,146,71,116,104,153,255,197,54,59.0,240,1175,583,592,98.5,1319,0,4,1137,564,573
41071,Yamhill County,OR,104831,52422,52409,100.0,5951,6670,6730,7515,7436,13101,13335,12958,6861,6670,10449,4975,2180,38.3,23555,81276,40362,40914,98.7,91772,878,1525,76587,37708,38879
42001,Adams County,PA,102470,50461,52009,97.0,5191,5586,6229,6769,6673,10983,10898,14641,7722,7474,11749,5951,2604,43.9,20804,81666,39901,41765,95.5,95038,1468,732,79323,38507,40816
42003,Allegheny County,PA,1221744,590342,631402,93.5,64170,61448,64402,71850,76324,186925,142006,151346,88829,88320,123499,66257,36368,40.8,229660,992084,473070,519014,91.1,976172,157060,45389,957449,454698,502751
42005,Armstrong County,PA,65867,32761,33106,99.0,3225,3854,3340,3519,3329,7006,7328,9285,5211,5534,7946,4452,1838,46.6,12679,53188,26284,26904,97.7,64325,548,201,53079,26228,26851
42007,Beaver County,PA,165833,80460,85373,94.2,8414,9157,8988,8944,9008,19447,18659,21947,13957,12599,18935,10793,4985,45.1,32213,133620,63987,69633,91.9,149833,9648,880,132743,63556,69187
42009,Bedford County,PA,48337,23972,24365,98.4,2333,2677,2674,2763,2591,4889,5190,6860,3727,3882,5754,3518,1479,46.5,9499,38838,19104,19734,96.8,47175,310,191,38616,18975,19641
42011,Berks County,PA,418025,205638,212387,96.8,24201,26437,26387,29529,27893,51171,48274,56927,30879,25599,39533,21599,9596,39.9,94038,323987,157536,166451,94.6,344474,22697,5850,310137,151021,159116
42013,Blair County,PA,123157,60259,62898,95.8,6496,6774,7431,7460,6508,15136,14108,16145,9565,8538,13710,7720,3566,43.4,25132,98025,47217,50808,92.9,117570,2053,756,97681,47054,50627
42015,Bradford County,PA,60963,30071,30892,97.3,3642,3687,3870,3418,3287,6694,6256,8107,4967,4364,7117,3667,1887,44.5,13431,47532,23339,24193,96.5,58934,337,437,46990,23076,23914
42017,Bucks County,PA,626806,307660,319146,96.4,30294,33914,39725,39264,36094,69294,73236,92809,52516,45942,64623,34005,15090,43.9,129169,497637,241461,256176,94.3,548891,25325,30282,477763,231459,246304
42019,Butler County,PA,186899,92531,94368,98.1,9530,9941,11216,12516,10736,21137,21996,26966,15013,13823,19279,9709,5037,43.3,37802,149097,73057,76040,96.1,179098,1821,2336,147156,72046,75110
42021,Cambria County,PA,133009,65461,67548,96.9,6609,6974,7324,8618,8308,13752,14328,17166,9836,10854,16001,8753,4486,45.4,25696,107313,52231,55082,94.8,124399,4618,579,106770,51861,54909
42023,Cameron County,PA,4611,2281,2330,97.9,207,199,192,265,200,402,429,656,391,435,692,339,204,52.0,767,3844,1885,1959,96.2,4449,4,39,3838,1885,1953
42025,Carbon County,PA,63887,31777,32110,99.0,2958,3339,3805,3526,3152,6916,7252,9555,5097,5091,7731,3679,1786,46.2,12390,51497,25471,26026,97.9,61135,1485,360,50994,25162,25832
42027,Centre County,PA,161960,85202,76758,111.0,6379,6500,7100,16074,26995,22816,17274,18107,9051,9358,12628,6808,2870,32.3,24346,137614,72756,64858,112.2,141849,6173,9923,128531,67995,60536
42029,Chester County,PA,519560,255927,263633,97.1,28992,32484,35770,36743,32262,59599,63822,74592,38530,34152,48087,23409,11118,40.4,119090,400470,195184,205286,95.1,440431,30438,28448,375793,182051,193742
42031,Clarion County,PA,38715,18881,19834,95.2,1985,2004,2038,2829,3421,4521,4016,4921,2798,2769,4055,2513,845,41.5,7305,31410,15152,16258,93.2,37325,527,231,31257,15128,16129
42033,Clearfield County,PA,79908,42011,37897,110.9,3778,4195,4245,4125,4444,9306,9854,11785,6753,5326,8843,5117,2137,45.0,14877,65031,34230,30801,111.1,75643,2302,401,63310,32682,30628
42035,Clinton County,PA,38915,19261,19654,98.0,2077,2133,2321,2988,4021,4426,3988,4671,2726,2443,3885,2109,1127,38.6,7876,31039,15222,15817,96.2,37447,696,323,30864,15111,15753
42037,Columbia County,PA,65715,31564,34151,92.4,2940,2958,3666,5317,7117,6798,6770,8370,5004,4332,7012,3712,1719,41.0,11606,54109,25719,28390,90.6,62515,1177,735,53609,25519,28090
42039,Crawford County,PA,85665,41716,43949,94.9,4688,4825,5100,5965,5358,9397,9112,11339,6524,6217,10218,5190,1732,43.2,17937,67728,32534,35194,92.4,81795,1384,485,67317,32305,35012
42041,Cumberland County,PA,249328,123397,125931,98.0,13357,14315,14150,16737,16106,32644,30600,32772,17650,15767,25499,13355,6376,40.6,50557,198771,97519,101252,96.3,218742,9884,10631,192222,94154,98068
42043,Dauphin County,PA,275632,133579,142053,94.0,17203,16101,18164,16447,16640,37953,32217,36715,19737,18906,26623,12967,5959,39.7,62069,213563,101961,111602,91.4,193282,53826,12073,204312,96718,107594
42045,Delaware County,PA,564554,271636,292918,92.7,33734,34065,35010,39651,38770,73139,67481,73800,41021,37481,49907,26124,14371,39.0,124897,439657,207628,232029,89.5,388106,121802,32094,416887,196775,220112
42047,Elk County,PA,30340,15319,15021,102.0,1529,1384,1870,1678,1639,2928,3133,4612,2748,2302,3478,2304,735,47.4,5887,24453,12306,12147,101.3,29663,268,153,24336,12272,12064
42049,Erie County,PA,273835,135238,138597,97.6,15458,16400,16540,19486,18425,35830,30653,34643,20056,18827,27029,13610,6878,39.7,58915,214920,104978,109942,95.5,236779,19663,4538,209813,102305,107508
42051,Fayette County,PA,131302,64835,66467,97.5,6693,6735,7247,7134,7324,15500,15073,18112,10000,10402,15303,7966,3813,45.0,25345,105957,52081,53876,96.7,121435,5502,474,105079,51447,53632
42053,Forest County,PA,7313,5318,1995,266.6,154,130,218,364,454,1443,1052,880,523,492,943,527,133,43.3,785,6528,4842,1686,287.2,5095,1893,8,6500,4820,1680
42055,Franklin County,PA,154147,75710,78437,96.5,9306,8802,10371,10072,8090,18062,18289,20639,10521,10322,16260,9286,4127,41.6,34619,119528,57997,61531,94.3,142470,5774,1296,116747,56672,60075
42057,Fulton County,PA,14506,7322,7184,101.9,696,876,813,818,791,1547,1625,2131,1079,1090,1735,988,317,45.4,2918,11588,5824,5764,101.0,14009,221,38,11543,5797,5746
42059,Greene County,PA,36870,19169,17701,108.3,1942,1898,2042,2326,2416,4502,4464,5106,2699,2652,4095,1817,911,42.2,7110,29760,15483,14277,108.4,34669,1152,132,29629,15393,14236
42061,Huntingdon County,PA,45369,24111,21258,113.4,2029,2178,2535,2895,2991,5391,5385,6081,3377,3208,5292,2998,1009,43.7,8272,37097,19917,17180,115.9,41519,2548,269,36653,19650,17003
42063,Indiana County,PA,85032,42572,42460,100.3,3991,4097,4450,7323,9610,8901,8407,10164,6209,5921,8991,4768,2200,40.2,15306,69726,34668,35058,98.9,80516,1955,840,68942,34321,34621
42065,Jefferson County,PA,43846,21839,22007,99.2,2488,2631,2558,2562,2380,5051,4752,5688,3550,3173,4946,2862,1205,43.9,9316,34530,17034,17496,97.4,42903,231,121,34452,16985,17467
42067,Juniata County,PA,24624,12304,12320,99.9,1416,1540,1540,1581,1253,2747,2765,3368,1768,1750,2743,1339,814,42.9,5573,19051,9512,9539,99.7,23882,270,97,18825,9357,9468
42069,Lackawanna County,PA,210652,102161,108491,94.2,11139,11575,12718,13218,13020,26288,23710,27786,14562,15314,22716,12187,6419,42.1,42986,167666,79996,87670,91.2,191885,5898,5921,162268,77390,84878
42071,Lancaster County,PA,540999,264955,276044,96.0,35479,36023,35010,36172,34342,70653,61375,66494,36441,34095,51149,29244,14522,38.6,128175,412824,199312,213512,93.3,478516,22580,11863,401812,193977,207835
42073,Lawrence County,PA,86727,41947,44780,93.7,4517,4540,5046,5304,5048,9266,9386,11318,6538,7104,10030,5981,2649,45.2,17289,69438,33215,36223,91.7,80717,3153,403,69073,33036,36037
42075,Lebanon County,PA,139729,68479,71250,96.1,8414,8654,9529,8926,8297,16314,16269,17808,9302,9474,14654,8372,3716,41.0,32032,107697,52185,55512,94.0,121005,3449,1989,105401,51141,54260
42077,Lehigh County,PA,365052,178570,186482,95.8,21541,22341,24129,24347,23803,47750,45198,47908,24726,23207,33464,17493,9145,39.1,82786,282266,135812,146454,92.7,289545,26932,12220,265980,127855,138125
42079,Luzerne County,PA,317663,157010,160653,97.7,16313,16833,17985,19441,20002,39846,36565,43532,22954,21907,34024,18338,9923,42.8,62555,255108,125110,129998,96.2,278303,16212,3968,245211,120210,125001
42081,Lycoming County,PA,114330,56067,58263,96.2,6237,6341,6892,7158,7190,14998,12705,14592,8460,8004,12093,6524,3136,41.5,23461,90869,44090,46779,94.3,105254,5665,809,89961,43585,46376
42083,McKean County,PA,41401,21416,19985,107.2,2054,2462,2147,2735,2609,4910,4761,5618,3206,3016,4300,2397,1186,43.2,8202,33199,17103,16096,106.3,39132,1048,212,32798,16794,16004
42085,Mercer County,PA,111518,54961,56557,97.2,5366,5543,6400,7808,7635,11557,11792,14873,8582,8338,12692,7047,3885,44.7,21873,89645,43721,45924,95.2,101788,6358,822,89214,43424,45790
42087,Mifflin County,PA,46276,22589,23687,95.4,2859,2844,2921,2670,2534,5115,4815,6251,3201,3279,5262,3190,1335,44.0,10390,35886,17324,18562,93.3,44839,248,153,35723,17219,18504
42089,Monroe County,PA,168032,83112,84920,97.9,7566,8779,9913,12885,12355,18578,18025,25179,14212,12266,17488,8072,2714,42.9,33335,134697,66200,68497,96.6,128246,24704,4096,129888,63678,66210
42091,Montgomery County,PA,823823,400410,423413,94.6,45563,49168,51952,51085,47252,102344,102710,114605,59931,56075,78286,42339,22513,41.2,178656,645167,309284,335883,92.1,651356,75690,62636,611701,292593,319108
42093,Montour County,PA,18259,8720,9539,91.4,1052,1044,919,1027,907,2443,1977,2294,1350,1478,1930,1188,650,43.3,3697,14562,6804,7758,87.7,17145,328,632,14287,6640,7647
42095,Northampton County,PA,302809,148943,153866,96.8,14711,16392,18098,21450,20114,35938,35178,41366,21996,21170,31195,16716,8485,42.2,60725,242084,117740,124344,94.7,259055,17264,8497,233598,113473,120125
42097,Northumberland County,PA,91761,46173,45588,101.3,4732,5222,4835,5004,4776,11212,10599,12407,6992,6840,10439,5700,3003,44.5,18023,73738,36812,36926,99.7,86804,2457,379,73271,36614,36657
42099,Perry County,PA,46053,23346,22707,102.8,2645,2740,2782,2702,2470,5346,5319,6782,3562,3412,5145,2402,746,43.3,9942,36111,18088,18023,100.4,44605,438,162,35899,17935,17964
42101,Philadelphia County,PA,1579075,747479,831596,89.9,106563,93264,93310,97295,115190,298061,195963,183971,93683,89501,121127,63319,27828,34.4,345561,1233514,571539,661975,86.3,642060,665333,114315,1136688,522066,614622
42103,Pike County,PA,55453,28148,27305,103.1,1894,2469,3397,3549,3069,5086,5980,8517,5346,3994,7358,3530,1264,48.2,10032,45421,22755,22666,100.4,49074,3526,661,44334,22135,22199
42105,Potter County,PA,16806,8389,8417,99.7,880,989,999,939,874,1638,1651,2191,1327,1365,2230,1221,502,47.2,3498,13308,6596,6712,98.3,16346,67,59,13263,6572,6691
42107,Schuylkill County,PA,142674,72953,69721,104.6,6992,7657,8479,7616,7432,16886,17475,20506,10740,10330,15933,8447,4181,44.4,28208,114466,58409,56057,104.2,133647,4538,703,113227,57734,55493
42109,Snyder County,PA,40483,20143,20340,99.0,2169,2263,2562,3335,3106,4395,4401,5369,2814,2650,4074,2459,886,40.2,8475,32008,15720,16288,96.5,39022,425,275,31795,15580,16215
42111,Somerset County,PA,74361,38821,35540,109.2,3455,3645,3906,3941,3953,8339,8828,10471,5963,5682,8833,4863,2482,46.1,13615,60746,31816,28930,110.0,70757,1913,251,60475,31625,28850
42113,Sullivan County,PA,6135,3243,2892,112.1,195,169,170,364,318,584,599,831,539,670,960,497,239,53.7,720,5415,2850,2565,111.1,5866,150,5,5364,2804,2560
42115,Susquehanna County,PA,40970,20601,20369,101.1,1845,2092,2322,2255,2082,4119,4087,5735,3718,3332,5406,2961,1016,48.4,7707,33263,16677,16586,100.5,39944,275,157,33048,16590,16458
42117,Tioga County,PA,40944,20319,20625,98.5,2142,2180,2347,2592,2540,4564,4304,5235,3314,2940,4893,2736,1157,44.6,8156,32788,16077,16711,96.2,39659,297,231,32615,16006,16609
42119,Union County,PA,45111,24755,20356,121.6,2085,2061,2319,4561,3472,5296,5604,6106,3018,2593,4151,2350,1495,39.5,8064,37047,20595,16452,125.2,39190,2898,754,36441,20160,16281
42121,Venango County,PA,51818,25583,26235,97.5,2560,2779,2885,2955,2641,5367,5572,6892,4381,4573,6384,3736,1093,46.9,10167,41651,20332,21319,95.4,50080,407,195,41547,20288,21259
42123,Warren County,PA,39756,19901,19855,100.2,1987,2123,2136,2282,2034,4044,4120,5505,3074,3569,4924,2806,1152,47.4,7740,32016,15968,16048,99.5,38843,192,191,31856,15903,15953
42125,Washington County,PA,207212,101740,105472,96.5,10458,12289,10640,12654,12207,23019,23600,28537,15529,16571,23533,12577,5598,44.5,40570,166642,81001,85641,94.6,193929,6498,1971,164999,80046,84953
42127,Wayne County,PA,51422,27286,24136,113.1,2149,2209,2528,2656,2609,5780,5667,7295,4233,4218,7224,3277,1577,48.2,8606,42816,22803,20013,113.9,48194,1639,304,42373,22559,19814
42129,Westmoreland County,PA,352590,172407,180183,95.7,16010,17986,18917,19810,19438,36930,38298,49668,28287,29185,43292,23517,11252,47.0,65147,287443,139146,148297,93.8,333734,8330,3257,285766,138398,147368
42131,Wyoming County,PA,27327,13779,13548,101.7,1318,1572,1419,1811,1643,3045,2935,3706,2175,2105,3384,1588,626,44.7,5355,21972,11007,10965,100.4,26534,297,60,21892,10979,10913
42133,York County,PA,445565,220122,225443,97.6,25568,27182,28629,28027,25793,54943,53744,62616,32890,30149,43976,22877,9171,41.0,98757,346808,169283,177525,95.4,393960,26395,6831,338795,165383,173412
44001,Bristol County,RI,48764,23599,25165,93.8,2012,2613,2712,4576,2715,5034,5067,7001,4328,3251,5116,3067,1272,44.3,9304,39460,18794,20666,90.9,45931,650,1006,38360,18146,20214
44003,Kent County,RI,163869,79292,84577,93.8,8077,8604,8743,8758,8657,21449,19778,24129,13091,12403,17382,8200,4598,43.9,31060,132809,63350,69459,91.2,149642,3157,4474,129692,61724,67968
44005,Newport County,RI,82801,40728,42073,96.8,3582,3819,4174,4852,5509,10393,8870,11295,6382,5982,10182,5452,2309,45.2,14132,68669,33588,35081,95.7,74408,3320,1616,66126,32393,33733
44007,Providence County,RI,635737,309399,326338,94.8,36330,35216,37191,43624,48691,96578,77499,83503,42678,39238,52488,27885,14816,37.4,131619,504118,241907,262211,92.3,463567,62698,26431,455855,215705,240150
44009,Washington County,RI,126060,60774,65286,93.1,4671,5725,6413,11198,11569,11763,12143,17165,9859,10432,14859,7039,3224,44.6,21229,104831,50043,54788,91.3,117049,1736,2431,102887,49243,53644
45001,Abbeville County,SC,24627,11941,12686,94.1,1291,1211,1643,1629,1735,2438,2639,3221,1728,1890,3197,1537,468,44.3,5077,19550,9340,10210,91.5,17221,6804,79,19422,9268,10154
45003,Aiken County,SC,168301,81237,87064,93.3,9697,10109,10271,10568,9593,21320,19678,21303,12249,11973,18861,8811,3868,41.0,36666,131635,62510,69125,90.4,118946,42002,1570,127008,60078,66930
45005,Allendale County,SC,9024,4828,4196,115.1,410,420,531,677,640,1003,1081,1269,575,641,1173,479,125,41.9,1694,7330,3909,3421,114.3,2108,6664,14,7179,3840,3339
45007,Anderson County,SC,198064,95539,102525,93.2,11581,12371,13542,12831,11645,23699,23789,26801,14122,12534,20801,10860,3488,40.8,45491,152573,72320,80253,90.1,157968,31183,1845,149715,70839,78876
45009,Bamberg County,SC,14376,6950,7426,93.6,667,980,703,1201,1212,1441,1413,1662,1036,1035,1669,922,435,41.7,2891,11485,5434,6051,89.8,5237,8786,50,11220,5388,5832
45011,Barnwell County,SC,21346,10337,11009,93.9,1326,1460,1438,1600,1251,2269,2394,2758,1600,1464,2319,962,505,41.3,5151,16195,7581,8614,88.0,10863,9785,36,16016,7459,8557
45013,Beaufort County,SC,186095,91501,94594,96.7,9906,9771,10078,10647,12069,21006,18459,19750,12797,12395,29884,14803,4530,45.5,35345,150750,73414,77336,94.9,138993,33027,2428,142932,69396,73536
45015,Berkeley County,SC,215044,106983,108061,99.0,13905,15284,13954,14107,14839,31581,28422,27696,14013,12366,18635,7834,2408,36.1,51562,163482,80699,82783,97.5,143238,51660,4766,157779,77697,80082
45017,Calhoun County,SC,14663,7003,7660,91.4,745,782,845,734,781,1491,1928,1738,1324,1065,2014,1048,168,45.5,2848,11815,5559,6256,88.9,8169,6001,4,11672,5461,6211
45019,Charleston County,SC,401165,194314,206851,93.9,23788,22595,20994,22296,25733,68464,51878,49092,27801,24691,39657,16602,7574,37.8,79464,321701,153698,168003,91.5,273817,107239,6052,309594,147205,162389
45021,Cherokee County,SC,56895,27531,29364,93.8,3314,3521,4057,4004,3429,7342,6792,7789,3944,3441,5578,2758,926,39.3,13222,43673,20967,22706,92.3,42974,11421,332,42820,20562,22258
45023,Chester County,SC,32311,15703,16608,94.6,1823,1900,2301,2119,1671,3742,3625,4510,2281,2465,3525,1691,658,42.0,7270,25041,11864,13177,90.0,19518,11972,65,24909,11779,13130
45025,Chesterfield County,SC,45953,22590,23363,96.7,2598,2371,3380,2860,2838,5223,5341,6617,3807,2673,5155,2423,667,42.4,10200,35753,17271,18482,93.4,28935,14701,230,35007,16756,18251
45027,Clarendon County,SC,33957,16739,17218,97.2,1623,2105,1683,1927,2359,3809,3424,4154,2311,2827,4658,2427,650,45.1,6627,27330,13357,13973,95.6,16729,16124,201,26849,13025,13824
45029,Colleton County,SC,37585,17952,19633,91.4,2113,2231,2455,2333,2300,4248,4341,4678,2575,2879,4533,2101,798,42.5,8427,29158,13759,15399,89.3,21523,14411,54,28770,13567,15203
45031,Darlington County,SC,67027,31723,35304,89.9,3908,3890,4471,4407,4214,7890,7685,8702,4855,4677,7555,3555,1218,41.4,15031,51996,24072,27924,86.2,37941,27547,247,51543,23804,27739
45033,Dillon County,SC,30689,14513,16176,89.7,2076,2336,2102,1914,1959,3822,3519,3882,2210,1983,2904,1475,507,37.7,7808,22881,10470,12411,84.4,14340,14998,22,22479,10269,12210
45035,Dorchester County,SC,158299,77077,81222,94.9,9616,11348,11337,10746,8943,21919,21681,21664,10499,9182,13752,5676,1936,37.0,39238,119061,57141,61920,92.3,106779,39720,2866,115357,55414,59943
45037,Edgefield County,SC,26927,14358,12569,114.2,1002,1323,1593,1861,1476,3318,3612,3801,2321,1670,3002,1470,478,42.9,4935,21992,11924,10068,118.4,16163,9511,81,21157,11230,9927
45039,Fairfield County,SC,22565,10780,11785,91.5,1022,980,1517,1371,1411,2231,2360,3140,1517,2392,2893,1254,477,46.4,4354,18211,8601,9610,89.5,8825,13234,41,18142,8564,9578
45041,Florence County,SC,138475,64765,73710,87.9,8502,9621,9291,8771,8750,17779,17014,17972,9126,9012,13945,6484,2208,39.2,32974,105501,48174,57327,84.0,74278,59193,1810,103842,47330,56512
45043,Georgetown County,SC,61952,29301,32651,89.7,2953,3023,3351,3594,3061,5849,6097,7428,4810,5072,10434,5031,1249,49.5,11567,50385,23358,27027,86.4,40114,19149,317,49453,22787,26666
45045,Greenville County,SC,507003,246053,260950,94.3,31917,33483,32827,31790,32397,70435,65209,67265,33066,30625,46905,23320,7764,38.2,117601,389402,186172,203230,91.6,372871,89504,12752,365131,173082,192049
45047,Greenwood County,SC,70411,32719,37692,86.8,4362,4636,4498,4745,4580,8600,8269,8998,4746,4218,7107,3980,1672,39.5,16170,54241,24588,29653,82.9,45307,22305,726,52794,23624,29170
45049,Hampton County,SC,19564,10152,9412,107.9,1076,1200,1180,1269,1082,2533,2464,2551,1490,1207,2104,945,463,40.0,4230,15334,7882,7452,105.8,8227,10451,63,14991,7626,7365
45051,Horry County,SC,332172,160275,171897,93.2,15832,16707,17718,18112,17318,39274,37141,41890,24699,26549,50673,20419,5840,45.9,60905,271267,129261,142006,91.0,269392,44187,4522,260441,123462,136979
45053,Jasper County,SC,28657,14375,14282,100.7,1726,1754,1676,1835,1486,3850,3588,3431,1734,2365,3603,1164,445,40.3,5997,22660,11360,11300,100.5,15011,11909,120,20795,10338,10457
45055,Kershaw County,SC,65112,31563,33549,94.1,3656,4221,4742,4017,3471,7526,7768,8665,4612,4730,7143,3288,1273,41.1,15304,49808,23617,26191,90.2,46360,15387,119,49119,23174,25945
45057,Lancaster County,SC,92308,44504,47804,93.1,5495,6281,5191,4751,4597,10751,12544,11957,5895,5991,11634,5468,1753,42.1,20067,72241,34490,37751,91.4,68565,19412,1212,69887,33420,36467
45059,Laurens County,SC,66846,32545,34301,94.9,3848,3840,4527,4276,4321,8028,7578,8994,4934,4507,7076,3413,1504,40.7,14703,52143,24755,27388,90.4,46860,16083,317,51063,24163,26900
45061,Lee County,SC,17365,8865,8500,104.3,855,872,1042,1069,1324,2183,2038,2316,1407,1119,1896,1006,238,41.8,3401,13964,7160,6804,105.2,5721,11163,8,13843,7112,6731
45063,Lexington County,SC,290278,141364,148914,94.9,17087,18280,20439,17872,16331,39039,37683,40018,19301,19467,27423,12545,4793,39.1,67656,222622,106914,115708,92.4,229664,43041,5427,214692,102356,112336
45065,McCormick County,SC,9531,5284,4247,124.4,285,281,329,386,399,905,966,1198,691,908,2039,941,203,55.2,1163,8368,4566,3802,120.1,4908,4271,23,8322,4529,3793
45067,Marion County,SC,31308,14448,16860,85.7,1942,1853,2217,1901,1757,3521,3698,3869,1947,2658,3725,1754,466,40.7,7212,24096,10771,13325,80.8,12414,17752,223,23632,10429,13203
45069,Marlboro County,SC,26753,13940,12813,108.8,1408,1533,1535,1517,1652,3791,3438,3629,1800,1798,2913,1340,399,40.3,5512,21241,11147,10094,110.4,11108,13511,116,20885,10840,10045
45071,Newberry County,SC,38194,18529,19665,94.2,2237,2440,2162,2688,2632,4111,4264,4862,2703,2750,4387,2077,881,42.0,8336,29858,14430,15428,93.5,24134,11878,93,28421,13698,14723
45073,Oconee County,SC,77528,38138,39390,96.8,3935,4477,4436,4354,4200,8743,7999,9827,6109,5790,10625,5358,1675,45.7,15650,61878,30196,31682,95.3,68062,5317,570,60517,29418,31099
45075,Orangeburg County,SC,87687,41012,46675,87.9,4815,5296,5997,6068,6311,10359,9057,10868,5511,6762,9947,4798,1898,40.3,19420,68267,31098,37169,83.7,30474,54107,572,67714,30856,36858
45077,Pickens County,SC,124029,61734,62295,99.1,6240,6498,6706,11383,15077,14621,13261,14989,8507,6749,11611,6522,1865,36.2,23611,100418,49610,50808,97.6,109519,8440,2483,97736,48087,49649
45079,Richland County,SC,411357,199147,212210,93.8,23911,24232,25102,38270,41584,61144,50684,48825,24068,22796,31729,13999,5013,33.4,88558,322799,154269,168530,91.5,184514,192946,11752,311681,148762,162919
45081,Saluda County,SC,20303,10141,10162,99.8,1236,1262,1217,1376,929,2198,2611,2690,1551,1334,2203,1285,411,41.8,4439,15864,7847,8017,97.9,13370,5091,0,14480,6947,7533
45083,Spartanburg County,SC,307617,149276,158341,94.3,18728,19864,20574,20642,20047,41403,36827,41433,19928,19172,29442,14057,5500,38.2,71558,236059,112909,123150,91.7,225093,62688,7240,226534,107990,118544
45085,Sumter County,SC,106757,51432,55325,93.0,7109,7193,7128,7053,8151,14817,11869,13052,7184,6253,9966,5155,1827,36.4,25845,80912,38251,42661,89.7,50412,49908,1467,79552,37638,41914
45087,Union County,SC,27490,13099,14391,91.0,1545,1649,1627,1595,1545,3095,3084,3813,2169,1974,3209,1676,509,44.0,5899,21591,10039,11552,86.9,18017,8441,4,21464,9962,11502
45089,Williamsburg County,SC,31324,14942,16382,91.2,1628,1847,1905,1905,2198,3367,3507,3995,2348,2357,3836,1970,461,43.0,6628,24696,11664,13032,89.5,9957,20217,213,24345,11417,12928
45091,York County,SC,265872,128270,137602,93.2,16192,18163,19269,17991,15469,33056,36729,38154,17162,16346,23595,10542,3204,38.7,64795,201077,95305,105772,90.1,197372,50998,5673,194449,91840,102609
46003,Aurora County,SD,2763,1461,1302,112.2,201,150,228,196,182,335,266,349,166,167,270,149,104,37.8,738,2025,1068,957,111.6,2548,46,0,1911,985,926
46005,Beadle County,SD,18346,9313,9033,103.1,1522,1465,1264,1067,916,2538,1844,1892,1253,1461,1610,890,624,38.1,4954,13392,6807,6585,103.4,14813,216,1673,11978,6017,5961
46007,Bennett County,SD,3425,1686,1739,97.0,336,381,340,279,202,466,364,320,135,204,189,183,26,28.6,1226,2199,1053,1146,91.9,1151,2,15,2182,1043,1139
46009,Bon Homme County,SD,6929,4064,2865,141.8,333,394,375,330,454,938,820,889,491,482,702,419,302,42.3,1338,5591,3374,2217,152.2,6134,102,28,5560,3347,2213
46011,Brookings County,SD,34601,17697,16904,104.7,2176,1932,1885,3945,6176,4675,3347,3096,1653,1665,2296,1340,415,27.0,7058,27543,14223,13320,106.8,31987,497,1060,26061,13212,12849
46013,Brown County,SD,38915,19166,19749,97.0,2418,2670,2514,2731,2874,5173,4277,4502,2503,2607,3482,2201,963,37.0,9142,29773,14565,15208,95.8,34768,923,1217,28916,14115,14801
46015,Brule County,SD,5258,2603,2655,98.0,324,303,475,295,287,523,585,646,430,460,479,257,194,40.9,1327,3931,1889,2042,92.5,4541,26,15,3913,1878,2035
46017,Buffalo County,SD,2026,1008,1018,99.0,230,207,178,216,162,240,252,215,107,73,105,33,8,25.8,767,1259,604,655,92.2,282,3,0,1259,604,655
46019,Butte County,SD,10225,5213,5012,104.0,604,771,716,685,510,1178,1027,1115,692,892,1185,496,354,40.1,2525,7700,3860,3840,100.5,9579,68,12,7661,3834,3827
46021,Campbell County,SD,1485,805,680,118.4,85,95,63,89,40,143,115,193,124,166,193,153,26,50.9,311,1174,622,552,112.7,1460,0,1,1174,622,552
46023,Charles Mix County,SD,9349,4705,4644,101.3,773,760,814,701,557,961,899,982,652,545,848,526,331,35.8,2781,6568,3241,3327,97.4,5906,8,11,6561,3236,3325
46025,Clark County,SD,3685,1854,1831,101.3,349,259,245,167,193,431,347,371,184,360,431,202,146,41.4,958,2727,1357,1370,99.1,3504,8,17,2672,1324,1348
46027,Clay County,SD,13957,6833,7124,95.9,717,604,681,1922,3080,1675,1203,1104,585,732,960,423,271,24.9,2358,11599,5579,6020,92.7,12357,260,403,11184,5424,5760
46029,Codington County,SD,28026,14135,13891,101.8,1734,2115,1754,1635,1737,3666,3332,3384,2167,1754,2487,1498,763,39.1,6679,21347,10680,10667,100.1,26425,219,151,21015,10450,10565
46031,Corson County,SD,4150,2097,2053,102.1,440,360,489,334,222,520,424,436,255,217,279,115,59,28.7,1512,2638,1323,1315,100.6,1202,14,1,2633,1323,1310
46033,Custer County,SD,8719,4233,4486,94.4,347,429,349,320,373,704,790,1074,661,1145,1619,730,178,54.8,1388,7331,3536,3795,93.2,8131,22,30,7189,3482,3707
46035,Davison County,SD,19871,9841,10030,98.1,1129,1235,1175,1423,1372,2762,2282,2255,1318,1342,1795,1147,636,38.6,4415,15456,7746,7710,100.5,18401,273,145,15238,7553,7685
46037,Day County,SD,5486,2843,2643,107.6,293,360,321,315,292,523,504,596,463,414,745,429,231,47.7,1228,4258,2180,2078,104.9,4765,5,7,4238,2166,2072
46039,Deuel County,SD,4318,2250,2068,108.8,279,291,289,193,252,480,457,517,292,349,503,282,134,42.8,1027,3291,1680,1611,104.3,4282,1,0,3229,1637,1592
46041,Dewey County,SD,5833,2893,2940,98.4,726,576,559,474,395,686,614,626,309,308,344,186,30,26.9,2157,3676,1765,1911,92.4,1161,5,5,3667,1756,1911
46043,Douglas County,SD,2929,1435,1494,96.1,205,194,189,157,151,276,241,336,242,250,341,169,178,46.7,721,2208,1084,1124,96.4,2782,0,0,2206,1082,1124
46045,Edmunds County,SD,3909,1969,1940,101.5,251,352,213,230,204,407,396,471,361,268,387,240,129,42.4,969,2940,1529,1411,108.4,3819,7,2,2903,1503,1400
46047,Fall River County,SD,6747,3398,3349,101.5,287,345,288,350,272,572,617,920,518,716,1093,511,258,53.6,1158,5589,2727,2862,95.3,5873,0,105,5530,2680,2850
46049,Faulk County,SD,2312,1168,1144,102.1,184,146,115,111,87,232,210,283,121,206,293,140,184,47.0,515,1797,876,921,95.1,2229,1,0,1797,876,921
46051,Grant County,SD,7149,3750,3399,110.3,409,498,379,422,466,719,789,869,558,573,815,462,190,42.9,1573,5576,2894,2682,107.9,6688,33,8,5344,2774,2570
46053,Gregory County,SD,4186,2149,2037,105.5,261,282,282,237,172,384,459,421,319,345,509,334,181,45.4,984,3202,1608,1594,100.9,3689,0,74,3198,1608,1590
46055,Haakon County,SD,2018,1016,1002,101.4,132,123,177,136,82,183,220,215,189,138,193,140,90,44.1,550,1468,744,724,102.8,1813,1,0,1468,744,724
46057,Hamlin County,SD,6025,3073,2952,104.1,561,418,612,441,325,654,682,632,391,359,515,321,114,35.0,1899,4126,2096,2030,103.3,5825,26,24,3997,2000,1997
46059,Hand County,SD,3256,1643,1613,101.9,188,243,170,137,237,300,305,378,306,201,351,283,157,47.4,702,2554,1303,1251,104.2,3194,4,19,2535,1284,1251
46061,Hanson County,SD,3399,1702,1697,100.3,274,244,362,276,169,303,426,403,184,251,373,101,33,36.7,1060,2339,1171,1168,100.3,3383,0,0,2337,1169,1168
46063,Harding County,SD,1306,681,625,109.0,70,97,50,100,85,170,131,167,79,128,164,59,6,42.3,300,1006,545,461,118.2,1219,27,0,985,542,443
46065,Hughes County,SD,17608,8611,8997,95.7,1193,1404,892,997,905,2521,2129,2112,1100,1395,1705,862,393,38.0,4102,13506,6527,6979,93.5,14808,24,3,13347,6514,6833
46067,Hutchinson County,SD,7308,3559,3749,94.9,624,447,490,387,366,711,741,791,576,486,768,503,418,43.0,1816,5492,2656,2836,93.7,7055,0,21,5445,2634,2811
46069,Hyde County,SD,1319,685,634,108.0,77,76,55,75,36,105,129,139,135,147,137,143,65,53.3,253,1066,540,526,102.7,1166,32,0,1066,540,526
46071,Jackson County,SD,3290,1631,1659,98.3,358,298,231,290,185,378,329,342,259,150,280,136,54,32.2,1039,2251,1132,1119,101.2,1282,10,14,2234,1122,1112
46073,Jerauld County,SD,2018,1001,1017,98.4,108,118,143,107,38,171,207,184,212,132,305,195,98,51.6,424,1594,773,821,94.2,1938,0,0,1563,754,809
46075,Jones County,SD,793,374,419,89.3,26,55,38,31,25,79,58,103,113,82,73,83,27,53.5,144,649,334,315,106.0,737,9,0,643,328,315
46077,Kingsbury County,SD,4944,2533,2411,105.1,319,296,315,265,240,507,525,556,335,464,588,317,217,45.1,1103,3841,1961,1880,104.3,4839,0,11,3831,1957,1874
46079,Lake County,SD,12717,6661,6056,110.0,751,594,858,927,839,1219,1339,1314,1139,1064,1800,591,282,43.2,2615,10102,5335,4767,111.9,11930,52,208,9968,5208,4760
46081,Lawrence County,SD,25478,12659,12819,98.8,1061,1233,1419,1796,2255,2985,2633,2710,2103,1913,3189,1532,649,42.1,4505,20973,10384,10589,98.1,23732,230,255,20485,10049,10436
46083,Lincoln County,SD,56826,28154,28672,98.2,4223,4922,4583,3382,3201,8153,8670,6775,3493,2497,4278,1735,914,34.9,16043,40783,19887,20896,95.2,53679,756,627,40000,19632,20368
46085,Lyman County,SD,3848,2004,1844,108.7,350,305,299,267,267,415,440,355,242,309,329,189,81,35.5,1132,2716,1406,1310,107.3,2167,4,24,2713,1403,1310
46087,McCook County,SD,5548,2776,2772,100.1,430,474,360,357,286,577,630,631,373,390,533,307,200,39.3,1519,4029,2005,2024,99.1,5324,39,0,3973,1965,2008
46089,McPherson County,SD,2297,1090,1207,90.3,168,119,147,104,141,161,201,252,202,125,271,230,176,50.2,492,1805,877,928,94.5,2213,48,18,1794,866,928
46091,Marshall County,SD,4891,2549,2342,108.8,379,368,345,300,220,575,468,504,353,364,580,300,135,39.8,1294,3597,1862,1735,107.3,4259,31,0,3489,1800,1689
46093,Meade County,SD,27717,14409,13308,108.3,1595,1999,1904,1549,2400,3832,3483,3077,1854,1840,2584,1071,529,36.5,6433,21284,11063,10221,108.2,25138,525,339,21103,11042,10061
46095,Mellette County,SD,2052,1020,1032,98.8,165,209,219,99,86,319,156,205,157,127,191,78,41,32.9,652,1400,719,681,105.6,795,3,0,1400,719,681
46097,Miner County,SD,2211,1125,1086,103.6,103,184,166,130,122,202,233,276,195,162,188,163,87,44.0,551,1660,840,820,102.4,2130,6,8,1654,840,814
46099,Minnehaha County,SD,188674,95110,93564,101.7,14464,13069,13063,11808,12312,29816,24609,22341,12353,10815,14504,6369,3151,34.9,47717,140957,70666,70291,100.5,161852,10709,3939,133967,66839,67128
46101,Moody County,SD,6507,3271,3236,101.1,429,517,448,407,303,726,701,789,503,448,644,453,139,39.9,1669,4838,2410,2428,99.3,5180,33,138,4791,2390,2401
46102,Oglala Lakota County,SD,14335,7024,7311,96.1,1469,1498,1550,1318,1229,2103,1542,1501,581,569,616,322,37,25.8,5325,9010,4334,4676,92.7,737,11,0,8988,4334,4654
46103,Pennington County,SD,110685,55795,54890,101.6,7360,7239,7011,6739,6752,14973,12866,12586,8080,7874,11653,5114,2438,39.0,25766,84919,42462,42457,100.0,91710,1336,1425,83614,41897,41717
46105,Perkins County,SD,2897,1504,1393,108.0,172,135,210,148,175,227,331,306,277,221,306,240,149,47.5,623,2274,1165,1109,105.0,2753,0,0,2263,1159,1104
46107,Potter County,SD,2315,1173,1142,102.7,157,161,109,116,114,221,192,231,185,185,327,186,131,49.2,499,1816,911,905,100.7,2119,0,41,1787,911,876
46109,Roberts County,SD,10287,5267,5020,104.9,791,735,832,651,725,1023,1004,1189,675,666,1146,631,219,38.1,2794,7493,3802,3691,103.0,5932,62,11,7450,3769,3681
46111,Sanborn County,SD,2379,1235,1144,108.0,221,147,126,99,129,298,246,243,186,211,290,114,69,42.6,572,1807,922,885,104.2,2292,0,11,1792,913,879
46115,Spink County,SD,6483,3238,3245,99.8,391,386,446,490,321,672,654,741,582,474,647,453,226,43.5,1574,4909,2403,2506,95.9,6260,14,0,4895,2392,2503
46117,Stanley County,SD,3017,1619,1398,115.8,204,240,159,122,130,297,377,367,218,251,404,197,51,44.5,688,2329,1194,1135,105.2,2745,0,0,2329,1194,1135
46119,Sully County,SD,1305,669,636,105.2,63,91,97,80,55,97,132,178,99,93,177,107,36,46.8,296,1009,522,487,107.2,1253,0,0,1009,522,487
46121,Todd County,SD,10195,4957,5238,94.6,1295,1199,1163,927,688,1385,1054,922,409,396,493,182,82,23.8,4261,5934,2818,3116,90.4,849,6,189,5921,2811,3110
46123,Tripp County,SD,5458,2768,2690,102.9,318,342,388,295,215,641,525,691,457,372,592,445,177,45.1,1257,4201,2106,2095,100.5,4426,0,44,4131,2063,2068
46125,Turner County,SD,8300,4148,4152,99.9,524,559,578,467,377,868,992,969,668,592,879,510,317,42.0,1991,6309,3114,3195,97.5,8094,38,24,6245,3082,3163
46127,Union County,SD,15368,7718,7650,100.9,895,913,1227,989,764,1860,1915,2047,1094,990,1571,744,359,40.0,3723,11645,5824,5821,100.1,14404,124,194,11408,5691,5717
46129,Walworth County,SD,5457,2714,2743,98.9,329,404,333,307,245,527,674,507,431,393,648,469,190,42.8,1258,4199,2084,2115,98.5,4370,275,0,4177,2073,2104
46135,Yankton County,SD,22717,11836,10881,108.8,1370,1260,1367,1360,1490,2602,2747,3122,1765,1456,2249,1329,600,41.8,4812,17905,9462,8443,112.1,20983,357,43,17724,9315,8409
46137,Ziebach County,SD,2791,1375,1416,97.1,179,242,260,257,208,308,408,336,205,126,156,75,31,33.1,846,1945,996,949,105.0,657,0,17,1929,984,945
47001,Anderson County,TN,76061,37152,38909,95.5,4115,4478,4601,4383,4219,9034,8854,10279,5872,5239,8590,4601,1796,43.3,16090,59971,28890,31081,93.0,69131,2671,982,58606,28201,30405
47003,Bedford County,TN,48292,23834,24458,97.4,3211,3022,3982,2982,3058,6418,5976,6484,2750,3150,4326,2153,780,37.9,12285,36007,17554,18453,95.1,41129,3908,96,33925,16239,17686
47005,Benton County,TN,16140,7937,8203,96.8,740,734,1085,959,820,1470,1729,2281,1263,1210,2290,1080,479,47.9,3149,12991,6267,6724,93.2,15319,487,28,12935,6227,6708
47007,Bledsoe County,TN,14836,8707,6129,142.1,843,743,774,713,731,1927,2076,2201,1245,927,1612,815,229,44.1,2832,12004,7053,4951,142.5,13343,491,10,11705,6782,4923
47009,Blount County,TN,129927,63046,66881,94.3,6511,7128,7808,8245,7240,14976,15226,18452,9258,9112,15435,7897,2639,43.7,26533,103394,49514,53880,91.9,121965,3461,1042,101259,48318,52941
47011,Bradley County,TN,105749,51468,54281,94.8,6054,6630,6377,7539,7123,13116,13349,14322,7050,6403,10345,5532,1909,39.5,23354,82395,39536,42859,92.2,95001,5358,1277,78594,37492,41102
47013,Campbell County,TN,39797,19434,20363,95.4,2214,2101,2419,2229,2169,4613,4739,5669,3035,2479,4676,2782,672,44.1,8223,31574,15239,16335,93.3,38710,127,170,31443,15169,16274
47015,Cannon County,TN,14178,6999,7179,97.5,757,1057,693,759,773,1865,1629,2037,1077,929,1553,697,352,42.0,3019,11159,5494,5665,97.0,13593,265,4,11008,5404,5604
47017,Carroll County,TN,27886,13613,14273,95.4,1601,1622,1740,1918,1719,3192,2843,3856,1874,1966,3247,1561,747,42.5,5957,21929,10475,11454,91.5,24211,2867,113,21775,10446,11329
47019,Carter County,TN,56433,27576,28857,95.6,2500,2656,3476,2947,2885,7027,6464,8191,4313,4022,6869,3704,1379,45.4,10558,45875,22182,23693,93.6,54369,967,254,45417,22044,23373
47021,Cheatham County,TN,40181,20034,20147,99.4,2179,2459,2583,2545,2184,5205,5150,6174,3322,2515,3798,1629,438,40.3,8908,31273,15419,15854,97.3,37993,637,184,30801,15178,15623
47023,Chester County,TN,17190,8276,8914,92.8,1103,770,1294,1557,1375,1954,1915,2227,967,1122,1687,904,315,37.7,3875,13315,6304,7011,89.9,14794,1535,78,13125,6241,6884
47025,Claiborne County,TN,31732,15406,16326,94.4,1663,1628,1657,1890,2172,3991,3655,4343,2197,2384,3801,1630,721,43.1,6023,25709,12365,13344,92.7,30581,321,247,25434,12252,13182
47027,Clay County,TN,7654,3669,3985,92.1,372,523,375,464,332,717,822,1128,610,494,1039,715,63,47.3,1550,6104,2967,3137,94.6,7258,183,8,6028,2943,3085
47029,Cocke County,TN,35552,17255,18297,94.3,1998,1840,2214,1917,1809,3939,3960,4961,2753,2748,4557,2176,680,45.2,7310,28242,13506,14736,91.7,33687,662,67,28119,13429,14690
47031,Coffee County,TN,55209,27141,28068,96.7,3505,3816,3623,3402,3253,6874,6585,7356,3777,3540,5333,3168,977,39.7,13231,41978,20237,21741,93.1,49924,2163,596,41028,19780,21248
47033,Crockett County,TN,14399,6834,7565,90.3,872,960,1058,913,771,1688,1700,1856,965,934,1538,768,376,40.7,3444,10955,5163,5792,89.1,11447,1877,48,10572,4940,5632
47035,Cumberland County,TN,59216,28973,30243,95.8,2789,3282,2726,2611,2870,5901,5410,6906,4350,4472,10375,6015,1509,51.0,10514,48702,23573,25129,93.8,57133,613,209,48254,23280,24974
47037,Davidson County,TN,687488,331298,356190,93.0,46404,40623,37256,38746,50097,137515,94027,81616,42265,36732,49669,23317,9221,34.3,145006,542482,257765,284717,90.5,440299,186295,24865,492851,231109,261742
47039,Decatur County,TN,11686,5730,5956,96.2,626,725,722,621,613,1076,1317,1517,812,918,1560,901,278,46.4,2504,9182,4400,4782,92.0,10780,518,0,9160,4387,4773
47041,DeKalb County,TN,19847,9857,9990,98.7,1132,1214,1163,1198,1020,2469,2426,2754,1317,1560,2176,1007,411,41.1,4332,15515,7590,7925,95.8,18582,360,54,14564,6981,7583
47043,Dickson County,TN,52680,25998,26682,97.4,3205,3128,3805,3223,2920,6919,6586,7489,3822,3405,4947,2356,875,39.1,12333,40347,19428,20919,92.9,48792,2213,264,39735,19188,20547
47045,Dyer County,TN,37416,18137,19279,94.1,2228,2153,2915,2571,2040,4476,4622,5052,2897,2031,3788,1785,858,40.5,8952,28464,13501,14963,90.2,30612,4836,290,28207,13373,14834
47047,Fayette County,TN,40164,19813,20351,97.4,2025,2129,2263,2219,2013,4463,4580,5488,3279,3374,5146,2495,690,45.8,7868,32296,15722,16574,94.9,27926,11000,269,32006,15603,16403
47049,Fentress County,TN,18213,9084,9129,99.5,1040,1142,947,1110,951,1872,1997,2593,1463,1266,2431,1064,337,45.2,3852,14361,7103,7258,97.9,17718,59,100,14293,7065,7228
47051,Franklin County,TN,41725,20463,21262,96.2,2102,2345,2316,3275,3133,4548,4639,5211,3340,2701,4794,2461,860,42.2,8476,33249,16054,17195,93.4,37735,1988,185,32693,15760,16933
47053,Gibson County,TN,49228,23623,25605,92.3,3088,3392,3271,3220,2839,5804,6020,6356,3573,2955,4855,2726,1129,39.9,11881,37347,17645,19702,89.6,38519,8423,156,36902,17352,19550
47055,Giles County,TN,29285,14316,14969,95.6,1693,1493,1870,1802,1694,3275,3054,4214,2279,2101,3398,1795,617,43.9,6113,23172,11181,11991,93.2,25222,2871,65,22930,11077,11853
47057,Grainger County,TN,23101,11585,11516,100.6,1114,1296,1362,1428,1267,2345,2745,3449,1661,1779,2845,1473,337,45.0,4704,18397,9122,9275,98.4,22474,104,64,17941,8831,9110
47059,Greene County,TN,68834,33654,35180,95.7,3245,3148,4385,4231,4070,7264,8301,9577,4830,5216,8587,4685,1295,44.7,13365,55469,26757,28712,93.2,65096,1501,273,54885,26416,28469
47061,Grundy County,TN,13344,6599,6745,97.8,758,801,809,802,766,1490,1567,1756,1063,792,1647,972,121,43.4,2894,10450,5066,5384,94.1,11758,96,26,10404,5045,5359
47063,Hamblen County,TN,64132,31457,32675,96.3,3912,4089,4351,3946,3936,7299,7857,8881,4300,4094,6674,3697,1096,40.7,14938,49194,23839,25355,94.0,56703,2964,562,46187,22224,23963
47065,Hamilton County,TN,360919,174207,186712,93.3,20878,20649,21440,21317,22761,51944,44741,46559,23967,24522,35649,18348,8144,39.7,75293,285626,135740,149886,90.6,271750,69100,7445,275580,130668,144912
47067,Hancock County,TN,6587,3305,3282,100.7,339,446,348,335,376,736,762,869,563,461,815,407,130,44.5,1389,5198,2572,2626,97.9,6476,33,39,5171,2559,2612
47069,Hardeman County,TN,25443,14252,11191,127.4,1017,1286,1655,1644,1620,3619,3294,3400,1645,1711,2706,1327,519,40.3,4823,20620,11645,8975,129.7,14022,10648,187,20437,11489,8948
47071,Hardin County,TN,25715,12519,13196,94.9,1306,1299,1650,1543,1357,2645,2904,3513,2117,1610,3274,1915,582,45.3,5315,20400,9795,10605,92.4,24251,1001,119,20198,9709,10489
47073,Hawkins County,TN,56611,27657,28954,95.5,2793,3041,3447,3345,3035,6217,6474,8329,4259,4036,7042,3411,1182,44.9,11461,45150,21852,23298,93.8,54363,747,299,44856,21751,23105
47075,Haywood County,TN,17623,8238,9385,87.8,1052,1134,1103,1207,931,1999,2058,2359,1319,1309,1898,815,439,42.0,3999,13624,6196,7428,83.4,8243,8950,8,13266,6016,7250
47077,Henderson County,TN,27977,13721,14256,96.2,1505,2056,1672,1796,1499,3186,3435,3922,2022,1865,2989,1568,462,41.5,6388,21589,10298,11291,91.2,25091,2192,35,21296,10188,11108
47079,Henry County,TN,32284,15498,16786,92.3,1713,1880,1926,1781,1604,3331,3608,4272,2420,2400,4285,2295,769,45.8,6695,25589,12253,13336,91.9,28754,2643,127,25460,12170,13290
47081,Hickman County,TN,24813,13034,11779,110.7,1355,1082,1759,1622,1532,3191,3116,3558,1953,1470,2510,1315,350,41.1,5261,19552,10292,9260,111.1,22891,1299,94,19419,10188,9231
47083,Houston County,TN,8164,4154,4010,103.6,388,564,494,575,389,906,890,1127,654,469,1019,552,137,43.9,1756,6408,3197,3211,99.6,7542,441,14,6380,3183,3197
47085,Humphreys County,TN,18435,8949,9486,94.3,927,1024,1269,1118,1056,2026,2233,2524,1326,1376,2069,1178,309,42.0,3880,14555,6931,7624,90.9,17271,430,129,14445,6915,7530
47087,Jackson County,TN,11682,5872,5810,101.1,501,574,622,680,606,1206,1366,1626,1029,907,1581,798,186,46.8,2111,9571,4768,4803,99.3,11177,40,5,9497,4758,4739
47089,Jefferson County,TN,53679,26332,27347,96.3,2589,3194,2864,3648,3390,5907,6040,7635,4084,3790,6322,3127,1089,43.9,10708,42971,20915,22056,94.8,51204,910,345,42015,20445,21570
47091,Johnson County,TN,17753,9593,8160,117.6,731,692,1041,861,934,2101,2276,2608,1325,1212,2349,1230,393,46.0,2994,14759,8031,6728,119.4,16694,613,85,14558,7933,6625
47093,Knox County,TN,461104,224184,236920,94.6,26465,27038,27369,30588,41278,62600,57586,59167,30291,27528,42049,20500,8645,37.4,97472,363632,174382,189250,92.1,394105,40147,10114,352259,168256,184003
47095,Lake County,TN,7401,4641,2760,168.2,319,327,196,370,551,1159,1191,1202,499,443,648,367,129,41.5,1061,6340,4110,2230,184.3,4997,2110,18,6279,4058,2221
47097,Lauderdale County,TN,25989,13340,12649,105.5,1493,1667,1722,1682,1673,3544,3535,3414,1721,1567,2434,1204,333,38.3,5976,20013,10286,9727,105.7,16359,8769,72,19775,10105,9670
47099,Lawrence County,TN,43390,21251,22139,96.0,2993,3186,2855,2814,2348,5222,4873,5942,2939,2566,4388,2345,919,39.3,10901,32489,15674,16815,93.2,41314,724,226,32244,15523,16721
47101,Lewis County,TN,12027,5823,6204,93.9,656,660,827,711,702,1333,1385,1507,739,1036,1498,826,147,43.3,2628,9399,4464,4935,90.5,11436,219,164,9294,4394,4900
47103,Lincoln County,TN,33924,16669,17255,96.6,1834,1732,2689,2101,1793,3598,4071,4593,2666,2445,3640,2084,678,42.6,7587,26337,12709,13628,93.3,30413,2428,195,25869,12435,13434
47105,Loudon County,TN,52340,25614,26726,95.8,2687,2888,2935,2843,2696,5181,5230,6511,3667,4180,8043,4275,1204,47.6,10296,42044,20396,21648,94.2,49169,510,375,39898,19182,20716
47107,McMinn County,TN,53053,25838,27215,94.9,2903,2706,3578,3338,3014,6213,6279,7220,3924,3602,5989,3235,1052,42.6,11248,41805,20174,21631,93.3,49050,1953,415,40909,19814,21095
47109,McNairy County,TN,25844,12548,13296,94.4,1425,1546,1653,1580,1455,2896,2935,3502,1801,1721,3167,1627,536,43.5,5680,20164,9706,10458,92.8,23639,1428,54,20094,9669,10425
47111,Macon County,TN,23842,11738,12104,97.0,1687,1499,1724,1408,1492,3149,2661,3309,1674,1507,2309,1008,415,39.4,5795,18047,8772,9275,94.6,22796,44,113,17574,8455,9119
47113,Madison County,TN,97625,46221,51404,89.9,6050,5372,6763,7218,7155,12086,11254,12321,6657,6744,9474,4788,1743,38.7,22028,75597,35054,40543,86.5,56534,36352,1054,74240,34309,39931
47115,Marion County,TN,28538,13878,14660,94.7,1644,1570,1752,1633,1591,3323,3301,3918,2026,2201,3397,1751,431,43.4,6037,22501,10810,11691,92.5,26529,734,136,22336,10770,11566
47117,Marshall County,TN,32965,16235,16730,97.0,1988,2211,2103,2249,1687,4263,4283,4486,2239,2273,3241,1420,522,38.9,7801,25164,12132,13032,93.1,29548,2491,106,24532,11741,12791
47119,Maury County,TN,91976,44440,47536,93.5,6126,5636,6311,5264,5044,12400,11954,12024,6781,6151,8765,4055,1465,39.1,21547,70429,33382,37047,90.1,77153,10571,866,68753,32619,36134
47121,Meigs County,TN,12104,5991,6113,98.0,626,544,833,711,582,1232,1414,1742,889,901,1737,729,164,46.0,2481,9623,4776,4847,98.5,11630,230,26,9617,4776,4841
47123,Monroe County,TN,46064,22679,23385,97.0,2657,2646,2774,2958,2461,5086,5194,6182,3351,3235,6007,2753,760,43.9,9921,36143,17699,18444,96.0,43415,961,185,35785,17495,18290
47125,Montgomery County,TN,200180,99949,100231,99.7,16864,14644,14576,12880,17323,38274,26545,22137,9774,8900,11347,4879,2037,30.8,53842,146338,72357,73981,97.8,141131,40208,4409,142741,70920,71821
47127,Moore County,TN,6378,3217,3161,101.8,341,396,295,359,397,531,867,936,447,502,741,418,148,45.0,1284,5094,2497,2597,96.1,5919,140,153,5037,2497,2540
47129,Morgan County,TN,21545,11783,9762,120.7,1049,840,1495,1213,1378,2881,2783,3207,1374,1568,2302,1114,341,41.6,4177,17368,9664,7704,125.4,20010,1239,11,17305,9630,7675
47131,Obion County,TN,30365,14609,15756,92.7,1726,1718,1972,2023,1649,3275,3713,3951,2193,2121,3459,1737,828,42.6,6660,23705,11287,12418,90.9,25859,3126,116,23380,11115,12265
47133,Overton County,TN,22068,10863,11205,96.9,1195,1416,1364,1344,1238,2376,2592,2989,1608,1513,2652,1308,473,43.0,4852,17216,8299,8917,93.1,21520,144,99,17105,8227,8878
47135,Perry County,TN,7962,3941,4021,98.0,500,442,464,553,432,848,901,1047,741,402,973,492,167,43.2,1760,6202,3072,3130,98.1,7372,218,178,6150,3048,3102
47137,Pickett County,TN,5079,2563,2516,101.9,225,215,304,272,175,498,537,694,323,471,799,491,75,50.1,931,4148,2042,2106,97.0,5054,9,0,4139,2033,2106
47139,Polk County,TN,16814,8366,8448,99.0,799,765,1115,961,886,1738,1960,2613,1566,962,2064,1120,265,45.6,3336,13478,6708,6770,99.1,16160,56,17,13401,6659,6742
47141,Putnam County,TN,77447,38268,39179,97.7,4460,4030,4833,5792,8222,9854,8872,9362,4413,4778,7564,3779,1488,36.4,16165,61282,30127,31155,96.7,72255,1720,1009,58898,28847,30051
47143,Rhea County,TN,32719,16199,16520,98.1,2131,2126,2060,2118,2173,3915,3651,4248,2178,2236,3509,1741,633,38.9,7592,25127,12360,12767,96.8,30879,746,156,24515,11981,12534
47145,Roane County,TN,53075,26124,26951,96.9,2422,2726,2844,3139,2800,5666,5670,7429,3981,4605,6918,3735,1140,46.4,10013,43062,20879,22183,94.1,49748,1227,418,42689,20677,22012
47147,Robertson County,TN,70280,34747,35533,97.8,4423,4528,5006,4659,3814,9022,9132,9894,5192,4421,6246,3179,764,39.0,17009,53271,26092,27179,96.0,61489,5110,391,51381,25002,26379
47149,Rutherford County,TN,315815,155575,160240,97.1,20686,21632,22606,22737,29817,46617,44589,41219,18307,15400,20389,8645,3171,33.5,78173,237642,115613,122029,94.7,242518,46723,10850,226011,109796,116215
47151,Scott County,TN,21969,10857,11112,97.7,1337,1487,1522,1458,1204,2612,2876,2927,1746,1167,2203,1053,377,39.4,5308,16661,8159,8502,96.0,21487,126,2,16626,8129,8497
47153,Sequatchie County,TN,14816,7391,7425,99.5,716,757,889,967,754,1777,1757,1985,1112,1141,1802,990,169,44.1,3014,11802,5867,5935,98.9,14382,33,0,11539,5629,5910
47155,Sevier County,TN,97068,47695,49373,96.6,5234,5219,5878,5604,5574,11880,11349,13430,7464,6748,11555,5031,2102,42.9,19895,77173,37264,39909,93.4,91964,910,759,73777,35288,38489
47157,Shelby County,TN,936374,444834,491540,90.5,66253,62936,67265,62215,65104,137490,117204,118515,58566,58131,75279,33775,13641,35.6,235181,701193,325735,375458,86.8,366180,502669,24626,666745,306704,360041
47159,Smith County,TN,19740,9868,9872,100.0,1124,1214,1390,1279,1107,2362,2261,2974,1405,1394,2021,901,308,40.3,4581,15159,7413,7746,95.7,18433,561,74,14963,7288,7675
47161,Stewart County,TN,13427,6612,6815,97.0,816,726,809,792,671,1547,1475,1948,897,1114,1620,823,189,44.2,2864,10563,5131,5432,94.5,12572,134,96,10418,5030,5388
47163,Sullivan County,TN,157050,76345,80705,94.6,7739,8331,8823,9021,8658,17709,17969,22339,10761,11947,19019,10840,3894,45.1,30577,126473,60696,65777,92.3,148183,3067,953,125347,60159,65188
47165,Sumner County,TN,183437,89689,93748,95.7,11154,12586,12114,11773,10133,22682,24466,25988,12584,11416,17411,7943,3187,39.8,43556,139881,67380,72501,92.9,159883,13457,2564,135787,65256,70531
47167,Tipton County,TN,61447,30265,31182,97.1,3734,4349,4283,4425,3564,7859,7727,8651,4638,3566,5331,2503,817,37.5,15144,46303,22469,23834,94.3,47750,11313,520,45919,22318,23601
47169,Trousdale County,TN,10231,5987,4244,141.1,595,578,456,688,718,2075,1288,1244,666,498,913,351,161,35.1,1930,8301,4849,3452,140.5,8690,1042,25,8223,4832,3391
47171,Unicoi County,TN,17811,9006,8805,102.3,724,867,910,902,1018,2096,1966,2454,1429,1317,2327,1393,408,46.5,3085,14726,7382,7344,100.5,17170,60,50,14310,7045,7265
47173,Union County,TN,19488,9616,9872,97.4,1025,1172,1292,1165,1001,2265,2347,2752,1522,1411,2220,1031,285,43.0,4245,15243,7451,7792,95.6,19021,98,54,15113,7378,7735
47175,Van Buren County,TN,5760,2898,2862,101.3,308,242,338,341,250,537,700,829,477,442,838,363,95,46.9,1084,4676,2338,2338,100.0,5545,16,0,4635,2329,2306
47177,Warren County,TN,40702,20242,20460,98.9,2444,2445,3027,2561,2335,4824,5209,5376,2608,2882,4108,2075,808,40.0,9628,31074,15226,15848,96.1,37221,862,283,29424,14044,15380
47179,Washington County,TN,127805,62285,65520,95.1,6451,6705,7352,8210,11463,15996,15027,16762,8563,8456,13356,6865,2599,40.2,24632,103173,49836,53337,93.4,116464,5340,2137,100078,48207,51871
47181,Wayne County,TN,16693,9172,7521,122.0,822,867,790,859,1004,2322,2194,2366,1158,1191,1799,1010,311,43.0,3050,13643,7495,6148,121.9,15258,1143,132,13583,7456,6127
47183,Weakley County,TN,33510,16406,17104,95.9,1719,1729,1872,3052,3646,3561,3579,4036,2114,2165,3316,1880,841,38.6,6481,27029,13032,13997,93.1,29651,2831,84,26697,12836,13861
47185,White County,TN,26800,13070,13730,95.2,1614,1503,1859,1655,1379,3017,3076,3608,1759,1956,3109,1670,595,43.2,5971,20829,9987,10842,92.1,25710,568,47,20708,9895,10813
47187,Williamson County,TN,225389,110242,115147,95.7,13436,17958,18578,17405,11667,20613,32983,35036,15854,13168,18031,8051,2609,39.1,61787,163602,78977,84625,93.3,200077,9281,9495,156298,75242,81056
47189,Wilson County,TN,136666,67205,69461,96.8,8126,9317,9396,8734,7223,16005,18813,19843,9665,8469,13311,6040,1724,40.4,32508,104158,50466,53692,94.0,119957,9757,2256,101349,49012,52337
48001,Anderson County,TX,57810,35201,22609,155.7,3045,3128,3119,2943,3502,8971,9571,8440,3349,3464,4905,2511,862,39.3,11248,46562,29445,17117,172.0,42217,12124,321,44467,27981,16486
48003,Andrews County,TX,18036,9174,8862,103.5,1551,1599,1613,1380,1193,2714,2276,2106,723,1071,1061,529,220,30.8,5688,12348,6279,6069,103.5,16108,122,65,10532,5368,5164
48005,Angelina County,TX,87322,42606,44716,95.3,5909,6392,6315,5976,5455,11258,10603,10887,5693,4987,7944,4147,1756,37.5,22448,64874,31329,33545,93.4,69651,12890,975,60145,29102,31043
48007,Aransas County,TX,24462,11904,12558,94.8,1136,1229,1320,1460,1439,1947,2309,3055,1818,2038,3761,2198,752,50.6,4589,19873,9704,10169,95.4,22115,354,489,18785,8894,9891
48009,Archer County,TX,8716,4347,4369,99.5,456,495,551,547,530,888,1009,1204,679,655,911,593,198,44.5,1894,6822,3381,3441,98.3,8315,83,15,6628,3272,3356
48011,Armstrong County,TX,1973,982,991,99.1,118,95,159,136,65,171,237,250,180,137,263,128,34,46.0,456,1517,736,781,94.2,1833,5,0,1506,725,781
48013,Atascosa County,TX,49528,24733,24795,99.7,3637,3474,4189,3667,3130,6500,6131,5913,2839,2949,4181,2171,747,35.4,13618,35910,17800,18110,98.3,45761,135,173,33659,16415,17244
48015,Austin County,TX,29764,14682,15082,97.3,1786,1996,2087,1976,1684,3327,3289,3684,2310,2048,3339,1613,625,40.7,7132,22632,11188,11444,97.8,23146,2684,111,20824,10312,10512
48017,Bailey County,TX,7100,3611,3489,103.5,458,550,434,752,637,862,870,697,436,419,502,395,88,33.3,2061,5039,2608,2431,107.3,5949,46,57,4383,2263,2120
48019,Bandera County,TX,22215,11192,11023,101.5,950,958,1183,987,1233,1732,2195,2893,1760,2451,3604,1827,442,52.2,3809,18406,9027,9379,96.2,19990,154,62,17723,8645,9078
48021,Bastrop County,TX,84522,42810,41712,102.6,5519,5485,6629,6001,5342,9595,10339,11305,6063,5941,8140,3072,1091,38.4,21566,62956,31901,31055,102.7,57462,6298,739,56258,28275,27983
48023,Baylor County,TX,3577,1746,1831,95.4,153,249,243,133,265,331,373,370,353,240,432,340,95,45.9,746,2831,1346,1485,90.6,3291,123,0,2790,1346,1444
48025,Bee County,TX,32611,19915,12696,156.9,1901,1741,2095,1950,2915,5503,4890,4218,2017,1476,2263,1171,471,35.3,6902,25709,16420,9289,176.8,28172,2399,176,25100,15960,9140
48027,Bell County,TX,348574,173837,174737,99.5,29720,26804,25737,24278,30516,58728,45076,37366,18162,15394,22042,10750,4001,31.0,96758,251816,124804,127012,98.3,220872,84435,10282,238613,118820,119793
48029,Bexar County,TX,1952843,964179,988664,97.5,139117,139022,141108,140804,145364,311189,263608,235576,109434,96244,137735,67008,26634,33.6,502367,1450476,708385,742091,95.5,1549704,149706,55742,1311582,636171,675411
48031,Blanco County,TX,11478,5931,5547,106.9,486,619,573,715,435,896,1180,1646,1152,902,1806,802,266,50.4,2098,9380,4728,4652,101.6,10256,3,165,9022,4579,4443
48033,Borden County,TX,613,293,320,91.6,100,29,26,29,11,77,51,45,30,48,116,32,19,41.7,179,434,216,218,99.1,598,0,0,434,216,218
48035,Bosque County,TX,18296,9013,9283,97.1,979,900,1326,1116,869,1769,1854,2218,1506,1255,2582,1373,549,46.6,3900,14396,6973,7423,93.9,17318,301,100,13672,6599,7073
48037,Bowie County,TX,93373,46960,46413,101.2,5987,5700,6702,5736,6000,12383,12372,11577,6069,5579,8766,4675,1827,38.0,22148,71225,35499,35726,99.4,64586,22879,983,69107,34279,34828
48039,Brazoria County,TX,360677,182333,178344,102.2,25023,27518,26944,24567,21225,50615,52834,48256,23057,18893,25907,11628,4210,35.8,95619,265058,133381,131677,101.3,261164,50437,24110,243682,123010,120672
48041,Brazos County,TX,222981,112629,110352,102.1,13682,12211,12782,22370,43357,35773,24525,20052,9905,8538,11771,5827,2188,26.5,45845,177136,89457,87679,102.0,171189,23807,13711,157519,77880,79639
48043,Brewster County,TX,9231,4648,4583,101.4,469,466,581,406,499,1134,1192,1097,588,727,1261,663,148,43.7,1769,7462,3764,3698,101.8,8352,19,170,7159,3607,3552
48045,Briscoe County,TX,1457,804,653,123.1,52,67,73,78,139,123,180,180,103,90,196,140,36,46.4,237,1220,681,539,126.3,1256,12,0,1153,645,508
48047,Brooks County,TX,7141,3807,3334,114.2,578,528,476,478,1034,1003,741,654,257,351,663,319,59,29.7,1890,5251,2867,2384,120.3,6450,48,0,4653,2391,2262
48049,Brown County,TX,37855,18681,19174,97.4,1965,2219,2532,2787,2286,4503,4246,4668,2843,2418,4217,2347,824,41.5,8387,29468,14418,15050,95.8,34554,1426,270,28675,14031,14644
48051,Burleson County,TX,18058,8951,9107,98.3,1079,1058,1127,1105,1067,1961,2022,2189,1251,1510,2145,1140,404,43.3,4015,14043,6845,7198,95.1,14421,2395,7,13240,6543,6697
48053,Burnet County,TX,46530,22992,23538,97.7,2417,2419,3168,3058,2831,4453,5143,5620,3608,3610,6076,3076,1051,44.6,9951,36579,17853,18726,95.3,42519,815,400,35080,17093,17987
48055,Caldwell County,TX,42144,21313,20831,102.3,2632,2813,2779,3357,3264,5690,5194,5314,2687,2643,3491,1488,792,35.9,10148,31996,15982,16014,99.8,34069,2561,423,28756,13920,14836
48057,Calhoun County,TX,21668,11082,10586,104.7,1446,1450,1557,1539,1296,2709,2519,2566,1744,1073,2112,1104,553,37.7,5355,16313,8327,7986,104.3,18645,597,1183,14841,7428,7413
48059,Callahan County,TX,13856,6899,6957,99.2,696,803,1034,865,619,1550,1518,1840,996,1087,1606,889,353,44.2,3102,10754,5282,5472,96.5,13058,126,69,10587,5189,5398
48061,Cameron County,TX,421666,204948,216718,94.6,34786,35303,36870,36371,31365,51609,51725,47338,21897,18937,31063,17795,6607,31.7,129734,291932,139030,152902,90.9,397718,2441,2900,231131,111865,119266
48063,Camp County,TX,12878,6266,6612,94.8,885,1038,933,795,779,1560,1309,1585,804,812,1427,730,221,37.6,3397,9481,4446,5035,88.3,9341,2136,56,8561,3953,4608
48065,Carson County,TX,6009,2897,3112,93.1,419,397,397,388,290,782,705,713,380,440,609,364,125,40.6,1476,4533,2193,2340,93.7,5657,48,22,4471,2172,2299
48067,Cass County,TX,30059,14496,15563,93.1,1708,1965,1906,1950,1469,3009,3393,3823,2255,1995,3674,2196,716,43.3,6785,23274,11056,12218,90.5,23401,5195,166,22904,10849,12055
48069,Castro County,TX,7673,3853,3820,100.9,595,777,534,644,462,848,930,762,398,559,709,285,170,34.8,2230,5443,2776,2667,104.1,6972,163,47,4512,2310,2202
48071,Chambers County,TX,41305,20939,20366,102.8,2786,3314,3384,3162,2542,5334,5701,5683,2722,2183,2872,1182,440,35.2,11584,29721,14873,14848,100.2,36369,2997,465,27751,13978,13773
48073,Cherokee County,TX,52118,26587,25531,104.1,3729,3768,3549,3770,3325,6110,6165,6489,3042,3285,5148,2668,1070,37.9,13321,38797,19709,19088,103.3,42374,7092,241,34968,17598,17370
48075,Childress County,TX,7253,4442,2811,158.0,300,427,408,306,634,1596,1083,691,372,432,476,342,186,34.5,1286,5967,3691,2276,162.2,6189,583,76,5472,3388,2084
48077,Clay County,TX,10403,5214,5189,100.5,458,577,691,592,527,1021,1162,1332,767,903,1336,749,288,46.6,2127,8276,4120,4156,99.1,9879,52,117,7995,4023,3972
48079,Cochran County,TX,2887,1495,1392,107.4,212,238,185,222,149,429,369,261,200,167,215,213,27,35.1,781,2106,1077,1029,104.7,2565,144,0,1831,925,906
48081,Coke County,TX,3303,1647,1656,99.5,93,173,281,190,64,256,459,422,229,195,538,313,90,48.1,691,2612,1242,1370,90.7,2971,32,0,2598,1242,1356
48083,Coleman County,TX,8334,4308,4026,107.0,464,515,476,496,236,798,920,961,816,593,1168,732,159,47.2,1785,6549,3368,3181,105.9,7300,134,42,6262,3240,3022
48085,Collin County,TX,973977,479151,494826,96.8,60900,70810,78001,70256,55682,124444,155438,147357,59148,47906,65797,29473,8765,36.9,256118,717859,348738,369121,94.5,673508,94720,147553,620933,298839,322094
48087,Collingsworth County,TX,2969,1493,1476,101.2,187,219,230,168,199,276,382,386,263,155,272,115,117,39.6,744,2225,1056,1169,90.3,2283,273,0,2063,963,1100
48089,Colorado County,TX,21224,10590,10634,99.6,1390,1310,1534,1567,1085,1872,2381,2346,1364,1781,2508,1571,515,42.9,4991,16233,8080,8153,99.1,15520,2740,5,15000,7268,7732
48091,Comal County,TX,141642,69980,71662,97.7,8184,8295,9865,8993,7569,15925,17110,19403,10217,10684,15691,6831,2875,42.2,32191,109451,53499,55952,95.6,128737,2901,1597,105003,51223,53780
48093,Comanche County,TX,13529,6798,6731,101.0,770,776,926,989,497,1319,1523,1609,885,988,1779,1238,230,44.8,3019,10510,5219,5291,98.6,12684,177,82,9848,4863,4985
48095,Concho County,TX,3266,2098,1168,179.6,94,146,170,142,88,435,534,545,287,173,372,200,80,45.3,496,2770,1774,996,178.1,3157,41,13,1944,981,963
48097,Cooke County,TX,40041,19871,20170,98.5,2731,2540,2555,2702,2488,4770,4373,4893,2775,2945,4267,2298,704,40.7,9550,30491,14874,15617,95.2,36719,1125,344,28210,13838,14372
48099,Coryell County,TX,75280,37556,37724,99.6,5271,4787,4888,4434,8124,14588,10860,8440,3564,2920,4450,2088,866,31.8,17429,57851,28733,29118,98.7,54825,10234,1546,55690,27750,27940
48101,Cottle County,TX,1642,741,901,82.2,155,124,126,128,42,221,99,233,83,90,193,113,35,37.1,513,1129,473,656,72.1,1149,238,0,1108,456,652
48103,Crane County,TX,4802,2458,2344,104.9,385,361,483,449,222,701,496,591,262,198,422,188,44,32.7,1468,3334,1670,1664,100.4,2543,129,95,2933,1489,1444
48105,Crockett County,TX,3484,1680,1804,93.1,170,283,232,289,140,478,428,545,148,250,368,100,53,38.8,846,2638,1322,1316,100.5,1494,24,0,2470,1251,1219
48107,Crosby County,TX,5836,2899,2937,98.7,390,377,536,477,309,626,760,556,375,370,551,414,95,38.4,1568,4268,2076,2192,94.7,5148,212,33,4151,2019,2132
48109,Culberson County,TX,2214,1260,954,132.1,230,187,119,130,123,325,203,314,160,96,161,95,71,34.4,638,1576,858,718,119.5,1733,3,13,1472,818,654
48111,Dallam County,TX,7304,3718,3586,103.7,692,662,669,492,278,1214,641,1077,476,319,438,267,79,31.7,2302,5002,2580,2422,106.5,6550,56,142,3931,1975,1956
48113,Dallas County,TX,2606868,1285388,1321480,97.3,194947,191985,190473,176648,183251,428092,359936,327242,151446,130118,166271,76211,30248,33.4,687338,1919530,935042,984488,95.0,1597069,588903,163971,1506744,718115,788629
48115,Dawson County,TX,12813,6939,5874,118.1,905,802,1093,795,1134,1986,1530,1312,744,634,996,565,317,33.5,3330,9483,5278,4205,125.5,9638,1036,24,9121,5068,4053
48117,Deaf Smith County,TX,18736,9387,9349,100.4,1655,1596,1659,1540,1287,2451,2233,2014,1027,938,1303,688,345,31.9,5866,12870,6362,6508,97.8,16799,191,118,10555,5097,5458
48119,Delta County,TX,5249,2488,2761,90.1,297,378,330,400,241,493,539,647,439,429,621,307,128,44.3,1222,4027,1958,2069,94.6,4594,461,28,4015,1951,2064
48121,Denton County,TX,833822,410114,423708,96.8,53055,58325,61006,59200,54827,124197,128613,121117,52284,39061,53486,21474,7177,35.5,208913,624909,303425,321484,94.4,619566,81758,72510,561166,270814,290352
48123,DeWitt County,TX,20340,10574,9766,108.3,1327,1238,1242,1256,892,2387,2733,2531,1416,1375,2135,1296,512,41.0,4607,15733,8288,7445,111.3,13159,1900,4,15166,8002,7164
48125,Dickens County,TX,2203,1084,1119,96.9,116,106,129,123,90,212,298,254,142,209,277,208,39,46.0,442,1761,875,886,98.8,2023,59,11,1679,801,878
48127,Dimmit County,TX,10438,5060,5378,94.1,751,886,983,822,528,1284,1416,965,514,526,1022,517,224,34.3,3069,7369,3516,3853,91.3,9366,4,147,6995,3355,3640
48129,Donley County,TX,3342,1700,1642,103.5,167,166,218,335,262,266,357,343,200,252,420,279,77,41.4,668,2674,1330,1344,99.0,3002,189,12,2621,1290,1331
48131,Duval County,TX,11268,5717,5551,103.0,805,629,1054,696,990,1305,1291,1245,869,406,1091,649,238,36.1,2900,8368,4316,4052,106.5,10705,148,0,8072,4208,3864
48133,Eastland County,TX,18273,9150,9123,100.3,1088,1070,987,1455,1188,1816,2064,1912,1276,1326,2220,1238,633,41.2,3823,14450,7262,7188,101.0,16816,599,123,14055,7123,6932
48135,Ector County,TX,160579,81516,79063,103.1,14628,14148,12500,11596,12287,26826,20488,17078,8362,7429,8953,4499,1785,30.4,48455,112124,56759,55365,102.5,129198,7702,1909,98664,49774,48890
48137,Edwards County,TX,1918,993,925,107.4,82,121,55,94,101,218,165,353,94,49,319,225,42,49.1,284,1634,819,815,100.5,1912,0,0,1611,809,802
48139,Ellis County,TX,173772,85705,88067,97.3,11665,12748,13797,12986,10839,22316,22880,23300,11380,9931,13587,6481,1862,36.2,46558,127214,61841,65373,94.6,141636,17580,1120,119689,57626,62063
48141,El Paso County,TX,836062,411665,424397,97.0,63882,61067,65658,64193,70582,124591,104109,96155,46494,39779,56267,30434,12851,32.2,229502,606560,294944,311616,94.6,666059,27876,10421,506386,251957,254429
48143,Erath County,TX,41841,20347,21494,94.7,2575,2611,2166,4081,6175,5384,4104,4385,2507,1978,3398,1609,868,30.4,8751,33090,15787,17303,91.2,37186,799,388,30585,14205,16380
48145,Falls County,TX,17272,8127,9145,88.9,1043,993,1093,895,1039,2618,2007,2280,1159,1050,1641,990,464,39.0,3672,13600,6317,7283,86.7,12433,4233,82,12958,5900,7058
48147,Fannin County,TX,34537,18246,16291,112.0,1740,1791,2466,2149,2116,4353,4094,4674,2417,2339,3631,1965,802,41.3,7318,27219,14576,12643,115.3,30288,1953,232,26032,13874,12158
48149,Fayette County,TX,25141,12393,12748,97.2,1268,1493,1543,1332,1238,2673,2387,2948,2015,2057,3406,2037,744,47.0,5157,19984,9748,10236,95.2,22671,1645,125,18974,9217,9757
48151,Fisher County,TX,3856,1833,2023,90.6,301,205,232,212,229,404,386,537,223,247,454,328,98,44.6,870,2986,1436,1550,92.6,3408,102,12,2910,1406,1504
48153,Floyd County,TX,5803,2828,2975,95.1,365,391,531,381,365,645,740,573,369,362,539,348,194,37.2,1556,4247,2046,2201,93.0,5375,242,10,3862,1828,2034
48155,Foard County,TX,1275,632,643,98.3,50,28,80,112,68,58,144,192,120,78,136,148,61,51.2,231,1044,527,517,101.9,1048,29,0,1016,508,508
48157,Fort Bend County,TX,765394,375912,389482,96.5,52818,59899,61388,56823,44255,93615,117048,107505,46580,44117,54028,20518,6800,36.3,211669,553725,267741,285984,93.6,395904,157134,154513,466249,225781,240468
48159,Franklin County,TX,10716,5245,5471,95.9,596,695,768,849,519,1071,1097,1327,748,722,1356,775,193,43.2,2590,8126,3941,4185,94.2,9213,473,5,7661,3739,3922
48161,Freestone County,TX,19714,10203,9511,107.3,1137,1367,1103,1250,942,2416,2534,2505,1318,1276,2154,1301,411,41.5,4486,15228,7888,7340,107.5,15857,2995,139,14436,7461,6975
48163,Frio County,TX,19871,11883,7988,148.8,1295,1266,1170,1788,1903,3754,2483,2088,842,814,1364,880,224,31.2,4742,15129,9353,5776,161.9,16342,718,170,12653,7600,5053
48165,Gaines County,TX,20706,10556,10150,104.0,2272,1961,2089,1801,1264,2892,2501,2131,1068,907,1059,573,188,27.8,7456,13250,6722,6528,103.0,19578,522,102,10492,5348,5144
48167,Galveston County,TX,332885,163877,169008,97.0,21273,22549,23376,22565,19955,44497,43728,43989,23811,20708,28677,13192,4565,37.7,81264,251621,122349,129272,94.6,262336,41809,10946,234352,113287,121065
48169,Garza County,TX,6070,3829,2241,170.9,260,261,198,356,486,916,1085,969,397,308,470,290,74,41.1,962,5108,3387,1721,196.8,5120,347,119,3146,1512,1634
48171,Gillespie County,TX,26459,12798,13661,93.7,1316,1252,1756,1600,1208,2120,2628,2806,1648,2367,3997,2625,1136,50.0,5330,21129,10054,11075,90.8,24065,29,32,19573,9122,10451
48173,Glasscock County,TX,1510,867,643,134.8,64,46,169,144,200,184,227,151,39,137,49,86,14,30.8,343,1167,631,536,117.7,1003,0,0,884,427,457
48175,Goliad County,TX,7565,3756,3809,98.6,292,501,576,395,486,662,792,970,655,572,932,640,92,46.1,1638,5927,2893,3034,95.4,6119,445,55,5696,2760,2936
48177,Gonzales County,TX,20731,10540,10191,103.4,1515,1450,1695,1391,1304,2515,2311,2447,1386,1324,1899,1133,361,36.3,5606,15125,7559,7566,99.9,13784,1382,76,13293,6422,6871
48179,Gray County,TX,22410,11819,10591,111.6,1609,1748,1444,1337,1478,2932,3032,2701,1538,1045,1883,1139,524,36.5,5735,16675,8977,7698,116.6,19089,1007,150,15362,8285,7077
48181,Grayson County,TX,131014,63944,67070,95.3,8271,8012,9613,8745,8062,15486,15503,16383,9873,8123,13560,6686,2697,39.9,31100,99914,48016,51898,92.5,113326,7182,2080,94397,44956,49441
48183,Gregg County,TX,123443,60105,63338,94.9,9094,9111,8742,8277,8398,17021,14763,14391,8019,7010,10411,5502,2704,35.6,31935,91508,43775,47733,91.7,92086,24707,1586,84384,39739,44645
48185,Grimes County,TX,27984,15171,12813,118.4,1530,1781,1865,1790,1832,3275,3540,3627,1843,2160,3077,1179,485,40.4,6309,21675,12029,9646,124.7,21756,4244,55,20350,11373,8977
48187,Guadalupe County,TX,158966,78619,80347,97.8,9993,11862,11151,11812,9659,20414,22415,21547,9881,8562,13157,6407,2106,37.0,40333,118633,57943,60690,95.5,116778,13085,2720,113525,55356,58169
48189,Hale County,TX,33826,17635,16191,108.9,2298,2361,2944,2794,2545,4637,4022,4062,1936,1745,2421,1332,729,33.4,9208,24618,12982,11636,111.6,29018,1706,104,22280,11626,10654
48191,Hall County,TX,3048,1534,1514,101.3,105,177,275,248,163,288,276,372,172,291,349,229,103,44.6,678,2370,1163,1207,96.4,2376,197,8,2116,1043,1073
48193,Hamilton County,TX,8332,4164,4168,99.9,492,440,498,559,420,886,837,902,681,575,1009,609,424,45.8,1731,6601,3263,3338,97.8,7939,66,0,6366,3134,3232
48195,Hansford County,TX,5520,2817,2703,104.2,447,373,486,468,373,601,582,757,300,282,472,258,121,35.1,1644,3876,1961,1915,102.4,5055,17,4,2900,1416,1484
48197,Hardeman County,TX,3945,1918,2027,94.6,198,211,281,205,285,458,395,531,250,286,494,235,116,43.5,820,3125,1558,1567,99.4,3469,232,0,2862,1407,1455
48199,Hardin County,TX,56765,27374,29391,93.1,3731,4246,3672,3539,3297,7048,7209,7099,4122,3450,5688,2756,908,39.2,14029,42736,20656,22080,93.6,51841,3279,351,42089,20312,21777
48201,Harris County,TX,4646630,2309012,2337618,98.8,352470,344290,348779,318598,318536,752050,663855,579087,262443,234374,295401,130198,46549,33.5,1245892,3400738,1674827,1725911,97.0,2905947,884292,324288,2705677,1310629,1395048
48203,Harrison County,TX,66580,32338,34242,94.4,4273,4582,5066,4792,3986,7736,8204,8135,4809,4032,6606,3062,1297,38.7,16900,49680,23959,25721,93.1,49704,13760,528,47737,22982,24755
48205,Hartley County,TX,5669,3346,2323,144.0,310,264,428,226,168,1064,1063,693,387,214,452,330,70,38.1,1218,4451,2738,1713,159.8,4808,425,82,4060,2421,1639
48207,Haskell County,TX,5726,2964,2762,107.3,232,325,289,434,438,586,723,678,305,454,704,389,169,43.5,1052,4674,2496,2178,114.6,5114,228,16,4179,2129,2050
48209,Hays County,TX,213366,106252,107114,99.2,13016,13743,14525,18171,26053,29894,28392,24678,11622,10454,14875,6252,1691,32.0,49369,163997,80927,83070,97.4,188901,8997,3348,153266,74755,78511
48211,Hemphill County,TX,3994,2032,1962,103.6,237,319,462,352,196,272,666,439,298,226,323,146,58,36.4,1261,2733,1435,1298,110.6,3629,40,1,2336,1210,1126
48213,Henderson County,TX,81070,39485,41585,95.0,4488,4379,5388,5190,4384,8871,8691,9942,5858,6061,10193,5853,1772,43.9,17464,63606,30617,32989,92.8,72540,5404,525,60976,29220,31756
48215,Hidalgo County,TX,855176,418867,436309,96.0,78603,75095,81504,74459,66255,114220,109246,92546,35894,34626,51937,30098,10693,29.2,281738,573438,275495,297943,92.5,737739,4669,8370,420931,205185,215746
48217,Hill County,TX,35689,17809,17880,99.6,2104,2352,2379,2480,1959,3895,3800,4429,2737,2222,4219,2414,699,42.1,8321,27368,13444,13924,96.6,30697,2340,143,25910,12744,13166
48219,Hockley County,TX,23064,11502,11562,99.5,1550,1573,1837,2014,1698,3118,2672,2545,1370,1399,1893,925,470,33.8,6030,17034,8385,8649,96.9,20383,746,83,15934,7759,8175
48221,Hood County,TX,58318,28416,29902,95.0,3172,3486,3416,3519,2655,6114,5650,6998,4530,4381,8251,4792,1354,47.0,12290,46028,22185,23843,93.0,55523,466,411,45446,21866,23580
48223,Hopkins County,TX,36486,17904,18582,96.4,2311,2407,2776,2377,2118,4453,4243,4504,2591,2040,3920,2112,634,39.2,9090,27396,13271,14125,94.0,30839,2586,243,25647,12328,13319
48225,Houston County,TX,22954,12452,10502,118.6,1172,1415,1120,1199,1403,2211,3084,3152,1700,1605,2630,1687,576,44.5,4498,18456,10071,8385,120.1,16003,5888,88,17949,9705,8244
48227,Howard County,TX,36349,20151,16198,124.4,2310,2141,2345,2360,2502,5524,5308,4899,2335,1945,2570,1561,549,36.5,8036,28313,16041,12272,130.7,30306,2020,252,24747,12709,12038
48229,Hudspeth County,TX,4415,2218,2197,101.0,211,446,223,313,286,704,557,442,281,277,363,256,56,37.0,1083,3332,1759,1573,111.8,2974,89,34,2003,935,1068
48231,Hunt County,TX,94162,46261,47901,96.6,5906,6187,6466,7023,6504,11442,11007,12297,6658,5786,8703,4751,1432,38.0,22526,71636,34872,36764,94.9,75231,7364,1216,67947,32905,35042
48233,Hutchinson County,TX,21344,10772,10572,101.9,1395,1602,1455,1614,1301,2488,2587,2527,1570,1335,1992,1096,382,38.0,5486,15858,7990,7868,101.6,19043,344,82,15371,7725,7646
48235,Irion County,TX,1620,838,782,107.2,66,169,155,105,86,161,145,214,96,150,146,76,51,42.7,425,1195,623,572,108.9,1233,66,0,1188,616,572
48237,Jack County,TX,8852,5053,3799,133.0,478,449,610,694,555,1212,1172,1115,565,492,873,512,125,39.6,1877,6975,4037,2938,137.4,8227,443,9,6657,3905,2752
48239,Jackson County,TX,14816,7316,7500,97.5,1010,986,1185,932,841,1703,1971,1628,1162,821,1384,772,421,37.7,3773,11043,5485,5558,98.7,12912,1010,162,9961,4805,5156
48241,Jasper County,TX,35506,17510,17996,97.3,2094,2426,2602,2352,1994,4010,3830,4495,2531,2297,4072,1972,831,40.5,8570,26936,13170,13766,95.7,27455,5889,177,26379,12842,13537
48243,Jeff Davis County,TX,2241,988,1253,78.9,61,66,195,102,119,77,220,230,132,276,572,148,43,55.8,376,1865,872,993,87.8,2167,23,0,1683,756,927
48245,Jefferson County,TX,254340,130051,124289,104.6,17575,17565,16091,16323,17752,37337,32481,31126,16313,15639,20429,11116,4593,36.2,60922,193418,99003,94415,104.9,148331,85682,9565,175460,89090,86370
48247,Jim Hogg County,TX,5231,2557,2674,95.6,520,367,490,481,336,510,605,365,338,475,394,273,77,32.4,1673,3558,1615,1943,83.1,5165,17,0,3427,1526,1901
48249,Jim Wells County,TX,40972,20117,20855,96.5,3109,3220,3233,3115,2595,5397,4977,4601,2219,2393,3500,1950,663,34.6,11463,29509,14368,15141,94.9,39004,271,216,28201,13650,14551
48251,Johnson County,TX,167212,83534,83678,99.8,11015,11877,13026,11931,10259,21157,21701,22220,11712,9168,14073,7150,1923,36.8,43566,123646,61111,62535,97.7,151615,5962,1627,119807,59054,60753
48253,Jones County,TX,19943,12527,7416,168.9,874,815,1185,914,1445,3613,3126,2584,1437,914,1731,937,368,38.2,3482,16461,10744,5717,187.9,13992,2889,77,15963,10344,5619
48255,Karnes County,TX,15545,9147,6398,143.0,912,941,843,1137,1019,2834,2139,1726,929,885,1137,695,348,35.4,3237,12308,7449,4859,153.3,11825,1053,161,11151,7027,4124
48257,Kaufman County,TX,123804,60806,62998,96.5,8878,9515,9974,9038,6970,16549,17336,16358,7957,6644,9037,4198,1350,35.5,34335,89469,43364,46105,94.1,100717,14662,1590,83893,40552,43341
48259,Kendall County,TX,43769,21485,22284,96.4,2119,2512,3630,3258,2340,4116,5605,5772,3343,2805,4758,2265,1246,41.4,10356,33413,16183,17230,93.9,39336,253,392,31721,15209,16512
48261,Kenedy County,TX,568,280,288,97.2,100,15,49,11,11,84,36,70,40,8,95,12,37,39.7,168,400,168,232,72.4,567,0,0,364,157,207
48263,Kent County,TX,647,295,352,83.8,22,63,38,52,0,24,105,53,50,58,96,62,24,51.0,159,488,215,273,78.8,592,6,0,488,215,273
48265,Kerr County,TX,51843,25027,26816,93.3,2652,2651,2875,3040,3018,5522,4853,5762,3475,3971,7478,4610,1936,47.4,10002,41841,19892,21949,90.6,45818,765,431,39559,18693,20866
48267,Kimble County,TX,4373,2168,2205,98.3,280,172,251,320,136,316,425,457,254,495,709,412,146,52.1,932,3441,1589,1852,85.8,4027,48,0,3357,1568,1789
48269,King County,TX,237,117,120,97.5,14,9,39,15,2,27,16,32,40,18,12,13,0,40.0,70,167,82,85,96.5,234,0,0,147,69,78
48271,Kinney County,TX,3659,2170,1489,145.7,100,102,138,188,174,526,382,453,480,212,569,176,159,49.8,470,3189,1877,1312,143.1,3521,5,0,2864,1626,1238
48273,Kleberg County,TX,30974,15656,15318,102.2,2125,2299,1809,2761,4797,4337,3258,2847,1327,1384,2253,1210,567,28.3,7523,23451,11890,11561,102.8,27421,1018,695,22385,11325,11060
48275,Knox County,TX,3705,1845,1860,99.2,263,293,286,252,213,355,382,450,225,307,346,233,100,39.5,988,2717,1335,1382,96.6,3142,206,40,2498,1185,1313
48277,Lamar County,TX,49611,23770,25841,92.0,3316,3225,3218,3240,2791,6072,5618,6281,3264,3203,5381,2984,1018,40.7,11825,37786,17831,19955,89.4,40350,6358,384,36583,17229,19354
48279,Lamb County,TX,13123,6583,6540,100.7,964,1022,1080,980,748,1520,1518,1492,933,697,1063,729,377,36.4,3666,9457,4699,4758,98.8,11819,515,73,8666,4307,4359
48281,Lampasas County,TX,20862,10426,10436,99.9,1120,885,1684,1403,1070,2130,2619,3079,1406,1552,2377,1125,412,43.1,4632,16230,8078,8152,99.1,18212,961,240,15673,7892,7781
48283,La Salle County,TX,7416,4322,3094,139.7,323,393,468,388,611,1332,983,1029,350,276,647,513,103,36.5,1498,5918,3573,2345,152.4,6454,108,12,5402,3187,2215
48285,Lavaca County,TX,20021,9697,10324,93.9,1202,1449,1336,1271,981,2078,2024,2292,1356,1370,2472,1442,748,43.4,4745,15276,7405,7871,94.1,15747,1281,94,14503,7004,7499
48287,Lee County,TX,17058,8530,8528,100.0,1060,915,1094,1258,1139,1758,2125,1970,1111,1414,1844,1004,366,41.1,3784,13274,6624,6650,99.6,13945,1917,182,12153,6165,5988
48289,Leon County,TX,17225,8569,8656,99.0,1047,1075,1129,1002,1003,1610,1881,1728,1196,1379,2406,1280,489,44.3,3897,13328,6572,6756,97.3,15331,1173,138,12739,6227,6512
48291,Liberty County,TX,83702,41320,42382,97.5,5969,5648,6562,5643,5616,11962,10568,10750,5694,4417,6789,3214,870,35.5,21854,61848,30147,31701,95.1,67404,8273,439,57480,27726,29754
48293,Limestone County,TX,23417,12010,11407,105.3,1468,1410,1453,1496,1389,2959,2858,2699,1672,1624,2646,1300,443,39.9,5274,18143,9316,8827,105.5,18013,4037,177,16623,8435,8188
48295,Lipscomb County,TX,3398,1712,1686,101.5,254,276,236,226,171,576,326,325,226,201,285,223,73,34.7,902,2496,1206,1290,93.5,2779,18,66,2179,1042,1137
48297,Live Oak County,TX,12139,6707,5432,123.5,660,618,721,865,603,1695,1475,1351,695,994,1365,787,310,42.2,2427,9712,5385,4327,124.5,11326,279,173,9104,4906,4198
48299,Llano County,TX,21047,10356,10691,96.9,821,880,935,738,832,1918,1421,2353,1417,2076,4102,2808,746,57.4,3160,17887,8544,9343,91.4,19456,143,65,17275,8224,9051
48301,Loving County,TX,98,54,44,122.7,21,4,0,0,2,9,12,0,11,14,22,3,0,55.2,25,73,45,28,160.7,95,0,0,61,39,22
48303,Lubbock County,TX,304808,150307,154501,97.3,20437,19724,21060,26054,37481,44823,35488,31032,16418,15178,21202,11597,4314,30.8,73061,231747,113240,118507,95.6,250230,21279,6728,221088,107136,113952
48305,Lynn County,TX,5830,3011,2819,106.8,388,516,430,398,291,697,723,666,321,413,533,325,129,37.3,1578,4252,2200,2052,107.2,5199,65,46,4054,2084,1970
48307,McCulloch County,TX,8057,4366,3691,118.3,512,454,526,446,468,879,778,1112,528,595,1022,448,289,44.6,1816,6241,3134,3107,100.9,6668,87,60,5898,2984,2914
48309,McLennan County,TX,251089,122580,128509,95.4,17564,16659,17322,21082,26200,32513,28571,27463,14035,14178,19901,10871,4730,33.3,62120,188969,90670,98299,92.2,196885,36746,4053,175345,83749,91596
48311,McMullen County,TX,774,413,361,114.4,64,55,89,26,44,89,123,53,51,38,83,36,23,38.2,224,550,313,237,132.1,765,0,0,529,297,232
48313,Madison County,TX,14197,8060,6137,131.3,879,774,797,784,1217,2610,1823,1697,612,849,1157,748,250,35.2,3042,11155,6625,4530,146.2,10357,2332,477,10017,5939,4078
48315,Marion County,TX,10017,4858,5159,94.2,441,512,521,521,443,918,1011,1328,876,854,1558,895,139,50.6,1796,8221,4034,4187,96.3,7292,2294,32,8091,3960,4131
48317,Martin County,TX,5649,2943,2706,108.8,460,384,619,481,384,618,542,847,379,252,391,253,39,32.7,1755,3894,1988,1906,104.3,4479,48,4,3761,1920,1841
48319,Mason County,TX,4186,2257,1929,117.0,272,288,250,303,210,233,474,422,369,344,628,325,68,46.3,996,3190,1615,1575,102.5,3705,2,101,2906,1410,1496
48321,Matagorda County,TX,36774,18349,18425,99.6,2612,2484,2839,2408,2329,4403,4088,4464,2404,2735,3458,1658,892,38.2,9493,27281,13597,13684,99.4,25145,3813,710,25009,12328,12681
48323,Maverick County,TX,58174,28973,29201,99.2,5451,4924,4814,5254,4891,7694,6849,6351,2501,2741,3884,2170,650,29.6,18326,39848,19696,20152,97.7,54104,280,318,29219,14903,14316
48325,Medina County,TX,50057,25816,24241,106.5,2930,3070,3476,3617,3348,6199,5696,6743,3359,3348,5016,2244,1011,39.0,11597,38460,19968,18492,108.0,45440,1331,359,37446,19393,18053
48327,Menard County,TX,2119,1158,961,120.5,9,103,122,92,30,282,197,299,153,166,320,282,64,51.8,266,1853,1003,850,118.0,1710,1,0,1747,950,797
48329,Midland County,TX,168167,85041,83126,102.3,14754,13538,12540,10758,11439,29915,22247,17593,9562,8566,9684,5056,2515,31.7,47708,120459,60422,60037,100.6,138180,11200,3356,107271,53499,53772
48331,Milam County,TX,24770,12270,12500,98.2,1519,1392,1856,1979,1343,2756,2357,3086,1636,1808,2839,1571,628,41.7,6051,18719,9079,9640,94.2,21121,2582,142,17949,8724,9225
48333,Mills County,TX,4889,2376,2513,94.5,167,279,353,357,158,357,423,653,330,308,734,511,259,52.1,937,3952,1871,2081,89.9,4804,19,11,3766,1806,1960
48335,Mitchell County,TX,8523,5179,3344,154.9,436,567,295,576,1075,1442,1057,998,469,292,657,494,165,33.9,1688,6835,4271,2564,166.6,6824,840,37,6545,4031,2514
48337,Montague County,TX,19489,9460,10029,94.3,1141,1343,1295,1087,991,1979,1970,2609,1324,1390,2528,1378,454,44.6,4467,15022,7330,7692,95.3,18607,131,0,14443,7057,7386
48339,Montgomery County,TX,571949,283117,288832,98.0,38701,43254,43148,39862,33610,72685,78591,78065,38509,32172,46257,20159,6936,37.1,151329,420620,206033,214587,96.0,494422,28396,16868,376273,182987,193286
48341,Moore County,TX,21399,11218,10181,110.2,1910,2210,1673,1572,1564,2831,2879,2329,1149,999,1308,664,311,30.8,6744,14655,7604,7051,107.8,16420,803,1463,10851,5625,5226
48343,Morris County,TX,12373,5865,6508,90.1,683,764,937,738,651,1273,1489,1377,842,962,1419,885,353,43.0,2842,9531,4469,5062,88.3,8570,2882,20,9165,4354,4811
48345,Motley County,TX,1252,675,577,117.0,51,136,78,83,24,206,68,116,50,47,242,116,35,41.3,319,933,527,406,129.8,1096,19,0,933,527,406
48347,Nacogdoches County,TX,65339,31350,33989,92.2,4269,4326,4155,6703,8253,7675,6596,6719,3940,3417,5484,2796,1006,30.9,15175,50164,23597,26567,88.8,49935,11583,1055,46706,21941,24765
48349,Navarro County,TX,48995,24098,24897,96.8,3576,3220,3888,3471,2874,5703,5718,6031,3343,2942,4708,2613,908,38.1,12855,36140,17528,18612,94.2,36379,5985,333,32438,15703,16735
48351,Newton County,TX,13914,7130,6784,105.1,632,780,843,1284,555,1571,1473,1954,956,1066,1605,953,242,44.3,2804,11110,5711,5399,105.8,10517,2823,77,11042,5684,5358
48353,Nolan County,TX,14904,7643,7261,105.3,1078,1055,1117,1283,872,1532,1751,1699,1014,873,1472,784,374,37.5,3872,11032,5575,5457,102.2,13090,888,43,10564,5270,5294
48355,Nueces County,TX,361540,178516,183024,97.5,24411,25096,24545,26737,25191,52471,45621,42794,22679,21112,29909,15598,5376,35.5,89538,272002,132614,139388,95.1,325660,13542,7501,253786,123262,130524
48357,Ochiltree County,TX,10131,5127,5004,102.5,850,775,1004,850,581,1390,1282,1121,656,558,653,275,136,32.3,3153,6978,3490,3488,100.1,8884,82,26,5606,2893,2713
48359,Oldham County,TX,2094,1106,988,111.9,120,123,297,207,84,196,284,209,154,111,210,76,23,35.9,704,1390,699,691,101.2,1928,66,39,1360,698,662
48361,Orange County,TX,84069,41719,42350,98.5,5757,5762,5788,5525,5098,10760,10192,10829,5699,5549,7592,4181,1337,37.9,20850,63219,30922,32297,95.7,73496,7327,1022,61534,29890,31644
48363,Palo Pinto County,TX,28540,14057,14483,97.1,1736,1938,1848,1949,1620,3323,3081,3372,1914,2211,3221,1698,629,40.6,6686,21854,10559,11295,93.5,26133,715,226,20705,9954,10751
48365,Panola County,TX,23327,11494,11833,97.1,1396,1272,1887,1562,1469,2719,2910,2475,1623,1658,2445,1402,509,39.2,5504,17823,8677,9146,94.9,18899,4032,57,17107,8234,8873
48367,Parker County,TX,133811,66500,67311,98.8,8256,9144,9808,9181,7635,15353,16765,18599,10105,8454,12813,5765,1933,39.7,33143,100668,49552,51116,96.9,124714,1781,757,96861,47282,49579
48369,Parmer County,TX,9718,4982,4736,105.2,754,758,878,694,645,1376,1118,1069,463,651,749,440,123,33.4,2850,6868,3570,3298,108.2,8409,116,42,5500,2761,2739
48371,Pecos County,TX,15815,8966,6849,130.9,1015,1296,981,981,998,2396,2238,2093,1037,768,1121,609,282,35.9,3888,11927,7025,4902,143.3,13059,556,96,10630,6295,4335
48373,Polk County,TX,48913,26465,22448,117.9,2591,2728,2885,2662,2845,5751,5631,6558,3876,4346,6198,2073,769,43.7,9913,39000,21268,17732,119.9,41071,4794,378,36966,19939,17027
48375,Potter County,TX,119674,61773,57901,106.7,9465,9543,8974,7865,8113,17978,15669,14151,7140,6193,8354,4211,2018,33.9,32932,86742,44894,41848,107.3,93546,12048,6469,75426,38778,36648
48377,Presidio County,TX,6975,3352,3623,92.5,492,578,478,712,304,464,774,676,383,431,909,694,80,41.9,1809,5166,2492,2674,93.2,6561,0,94,3282,1709,1573
48379,Rains County,TX,11766,5912,5854,101.0,592,566,708,648,518,1148,1297,1445,1061,890,1790,932,171,48.4,2294,9472,4660,4812,96.8,10505,415,42,9160,4516,4644
48381,Randall County,TX,134026,65721,68305,96.2,8664,9250,8930,9621,9171,19434,17419,15482,8071,8325,11547,6139,1973,35.9,32237,101789,49354,52435,94.1,118890,3678,2589,98035,47397,50638
48383,Reagan County,TX,3766,1955,1811,108.0,328,427,353,221,262,616,500,366,201,184,168,69,71,30.0,1231,2535,1293,1242,104.1,1719,32,6,2132,1102,1030
48385,Real County,TX,3408,1498,1910,78.4,230,251,243,262,165,322,164,298,259,239,450,460,65,47.4,877,2531,1118,1413,79.1,3245,19,2,2431,1081,1350
48387,Red River County,TX,12171,5759,6412,89.8,538,520,916,741,535,1239,1488,1415,972,832,1645,1044,286,45.9,2441,9730,4545,5185,87.7,9642,2039,10,9527,4452,5075
48389,Reeves County,TX,15492,8744,6748,129.6,900,967,967,1256,902,2549,2541,1857,834,758,1106,592,263,35.8,3435,12057,6980,5077,137.5,12014,446,204,9704,4900,4804
48391,Refugio County,TX,7145,3439,3706,92.8,425,338,593,519,453,708,716,868,540,439,871,497,178,43.3,1656,5489,2658,2831,93.9,5766,480,21,5448,2649,2799
48393,Roberts County,TX,805,387,418,92.6,28,45,84,71,17,82,88,69,64,51,91,92,23,43.2,217,588,290,298,97.3,782,0,0,588,290,298
48395,Robertson County,TX,16990,8315,8675,95.9,1101,1109,1160,938,1083,1821,1853,2358,1108,1230,1935,833,461,41.5,4041,12949,6237,6712,92.9,12988,3474,31,12217,5849,6368
48397,Rockwall County,TX,97175,47995,49180,97.6,6000,7085,8351,7528,5126,10964,14621,13930,6665,5151,7249,3407,1098,37.5,26392,70783,34467,36316,94.9,82587,6148,2642,66597,32222,34375
48399,Runnels County,TX,10277,5160,5117,100.8,567,715,652,658,623,1117,1111,1296,673,744,1135,689,297,40.8,2396,7881,3897,3984,97.8,9510,309,11,7673,3763,3910
48401,Rusk County,TX,53755,28614,25141,113.8,3090,3594,3371,3574,3283,7168,7103,6865,3700,3177,5052,2832,946,38.2,12149,41606,22489,19117,117.6,41975,9075,279,39018,21029,17989
48403,Sabine County,TX,10471,5013,5458,91.8,491,457,639,621,335,953,865,1137,1032,749,1849,1019,324,53.0,1963,8508,4139,4369,94.7,9348,591,10,8475,4110,4365
48405,San Augustine County,TX,8286,3969,4317,91.9,418,329,570,659,214,716,795,1078,706,617,1273,702,209,49.3,1642,6644,3179,3465,91.7,6111,1768,14,6505,3117,3388
48407,San Jacinto County,TX,28180,13797,14383,95.9,1455,1564,2231,1569,1408,2852,3062,3429,2472,1911,3785,1871,571,44.9,6238,21942,10792,11150,96.8,24134,2598,9,20782,10255,10527
48409,San Patricio County,TX,67008,33774,33234,101.6,4862,4786,5358,4818,4320,8940,8450,7940,4348,3396,5822,3018,950,35.5,18102,48906,24353,24553,99.2,61845,1171,676,46800,23111,23689
48411,San Saba County,TX,5991,3077,2914,105.6,310,289,399,310,476,713,670,676,344,422,778,463,141,42.4,1244,4747,2463,2284,107.8,5101,121,9,4326,2132,2194
48413,Schleicher County,TX,2983,1505,1478,101.8,217,221,225,176,176,432,313,328,159,176,361,122,77,36.2,789,2194,1099,1095,100.4,1853,16,0,1998,971,1027
48415,Scurry County,TX,17096,9277,7819,118.6,1143,1042,1470,1413,887,2263,2332,1963,1030,975,1380,830,368,36.4,4299,12797,7047,5750,122.6,14721,792,51,12331,6711,5620
48417,Shackelford County,TX,3296,1750,1546,113.2,204,224,178,293,158,359,311,422,327,188,339,224,69,43.0,772,2524,1179,1345,87.7,3158,7,8,2480,1156,1324
48419,Shelby County,TX,25349,12585,12764,98.6,1807,1746,1965,1917,1679,2733,2806,3086,1546,1659,2481,1405,519,38.0,6653,18696,9183,9513,96.5,19732,4847,114,17131,8318,8813
48421,Sherman County,TX,3059,1596,1463,109.1,174,136,224,261,188,316,440,462,202,248,198,172,38,40.1,690,2369,1238,1131,109.5,2702,37,0,2016,1043,973
48423,Smith County,TX,227449,109770,117679,93.3,15529,15574,15576,16007,15848,31037,26815,26679,14891,12649,20890,11972,3982,36.6,56012,171437,81079,90358,89.7,174650,39690,3868,160259,75547,84712
48425,Somervell County,TX,8860,4448,4412,100.8,448,422,779,457,507,1133,1097,1095,799,499,981,432,211,41.0,1997,6863,3401,3462,98.2,7865,105,24,6755,3331,3424
48427,Starr County,TX,64078,31183,32895,94.8,6345,5914,5472,5526,5224,8488,7570,7032,2485,2826,4029,2417,750,28.8,21154,42924,20661,22263,92.8,61060,49,10,30503,14934,15569
48429,Stephens County,TX,9364,4858,4506,107.8,481,634,660,761,539,1059,1069,1061,628,647,1005,513,307,39.4,2119,7245,3778,3467,109.0,8441,265,31,6976,3666,3310
48431,Sterling County,TX,1231,678,553,122.6,77,152,86,120,21,118,122,216,119,44,94,42,20,40.8,424,807,395,412,95.9,1122,0,0,751,352,399
48433,Stonewall County,TX,1476,720,756,95.2,124,59,141,108,56,100,119,179,131,159,142,100,58,47.1,398,1078,532,546,97.4,1363,30,0,1061,531,530
48435,Sutton County,TX,3824,2065,1759,117.4,330,244,318,153,219,506,475,321,358,209,406,161,124,38.6,1009,2815,1475,1340,110.1,2395,3,0,2526,1320,1206
48437,Swisher County,TX,7432,4052,3380,119.9,453,498,547,470,452,1131,992,731,461,332,772,366,227,35.9,1875,5557,3013,2544,118.4,6222,448,12,4855,2667,2188
48439,Tarrant County,TX,2049770,1002709,1047061,95.8,144559,150907,156722,146403,137167,305953,280809,269467,122810,109235,138550,62369,24819,34.4,543644,1506126,725944,780182,93.0,1374182,338378,111274,1326447,635351,691096
48441,Taylor County,TX,136870,66757,70113,95.2,10069,9030,9481,10414,14358,20032,15327,13726,7627,7324,10561,6430,2491,32.5,33882,102988,49653,53335,93.1,104989,10946,3002,98730,47693,51037
48443,Terrell County,TX,896,423,473,89.4,26,62,25,22,7,69,125,103,65,99,205,73,15,55.2,135,761,351,410,85.6,592,10,0,750,347,403
48445,Terry County,TX,12528,6420,6108,105.1,1039,1004,876,966,653,1844,1436,1440,812,569,1061,630,198,34.6,3450,9078,4850,4228,114.7,11418,609,2,8197,4322,3875
48447,Throckmorton County,TX,1436,658,778,84.6,77,49,53,94,73,146,112,185,110,135,209,148,45,52.3,230,1206,570,636,89.6,1404,14,0,1206,570,636
48449,Titus County,TX,32640,16066,16574,96.9,2519,2818,2535,2573,2291,3958,3812,4056,1609,1908,2650,1480,431,34.1,9433,23207,11300,11907,94.9,22968,2926,357,18807,9005,9802
48451,Tom Green County,TX,117986,58707,59279,99.0,8021,7344,8353,8930,9757,18355,13233,12518,7148,6490,10172,5181,2484,34.1,28036,89950,44557,45393,98.2,102396,5015,1524,86339,42710,43629
48453,Travis County,TX,1226805,619629,607176,102.1,78278,74809,74831,74035,81822,246918,195045,156630,67950,60004,74938,29168,12377,34.2,269975,956830,481612,475218,101.3,889046,101955,82257,826560,410649,415911
48455,Trinity County,TX,14620,7022,7598,92.4,729,924,858,781,737,1316,1366,1793,1109,1174,2156,1275,402,48.6,2988,11632,5566,6066,91.8,12557,1454,5,11287,5363,5924
48457,Tyler County,TX,21518,11699,9819,119.1,1016,1175,1151,1334,1726,2804,2234,2415,1610,1410,2642,1492,509,42.4,4162,17356,9450,7906,119.5,18209,2305,70,16922,9166,7756
48459,Upshur County,TX,41018,20139,20879,96.5,2370,2972,2758,2697,2324,4401,4813,5291,3112,2930,4209,2509,632,41.4,9814,31204,15118,16086,94.0,35529,3370,128,30175,14572,15603
48461,Upton County,TX,3659,1901,1758,108.1,259,192,310,301,167,336,517,456,245,265,331,209,71,39.6,958,2701,1427,1274,112.0,1648,220,26,2417,1291,1126
48463,Uvalde County,TX,26920,13185,13735,96.0,1976,1678,2347,2242,1937,3535,3021,2849,1167,1674,2506,1648,340,33.7,7297,19623,9521,10102,94.2,25125,170,266,17821,8492,9329
48465,Val Verde County,TX,48969,24997,23972,104.3,4132,3338,4151,3788,4058,7093,5742,5403,2010,2326,3817,1971,1140,31.8,13944,35025,17916,17109,104.7,45407,706,369,29360,15120,14240
48467,Van Zandt County,TX,55103,27074,28029,96.6,3129,3361,3852,3859,2750,5846,6217,7158,3525,4358,6358,3670,1020,42.8,12773,42330,20465,21865,93.6,51331,1543,271,40974,19794,21180
48469,Victoria County,TX,92109,45075,47034,95.8,6491,6428,6665,6291,5982,12770,11211,10454,5900,5350,8466,4191,1910,35.9,23484,68625,33126,35499,93.3,80546,5488,1067,64906,31442,33464
48471,Walker County,TX,72321,42217,30104,140.2,3065,2948,3156,5464,11091,10054,9620,9608,4247,3881,5505,2427,1255,35.3,10801,61520,36716,24804,148.0,52800,16780,920,57185,34130,23055
48473,Waller County,TX,51832,25844,25988,99.4,3383,3761,3454,5772,6882,6033,5339,5523,3134,2538,3815,1601,597,28.9,12531,39301,19339,19962,96.9,30096,12911,530,34532,16756,17776
48475,Ward County,TX,11658,5812,5846,99.4,851,863,941,874,760,1619,1584,1261,623,676,910,519,177,33.9,3222,8436,4274,4162,102.7,10052,469,111,7923,4011,3912
48477,Washington County,TX,35163,17282,17881,96.7,2112,1785,2432,3187,2159,3436,3740,3917,2227,2792,3793,2337,1246,41.5,7701,27462,13236,14226,93.0,27569,5805,582,25706,12291,13415
48479,Webb County,TX,273526,133948,139578,96.0,26080,23926,25931,24429,21836,36837,35414,30715,12559,10658,14831,6952,3358,28.8,90913,182613,87727,94886,92.5,262244,1215,1387,136714,66743,69971
48481,Wharton County,TX,41577,20419,21158,96.5,2836,2650,3448,3088,2565,5099,4710,4891,2877,2494,3846,2111,962,37.3,10802,30775,14944,15831,94.4,33504,5944,142,28062,13522,14540
48483,Wheeler County,TX,5338,2746,2592,105.9,360,476,334,282,262,730,576,572,476,246,579,305,140,39.6,1369,3969,1952,2017,96.8,4678,171,3,3631,1765,1866
48485,Wichita County,TX,131596,68389,63207,108.2,8527,8487,7935,10520,11826,19714,15113,14505,8645,7281,10402,6065,2576,34.5,29430,102166,53201,48965,108.7,103920,13623,3109,97710,50735,46975
48487,Wilbarger County,TX,12833,6266,6567,95.4,701,857,804,1016,599,1832,1335,1541,958,822,1373,795,200,39.4,2876,9957,4864,5093,95.5,10017,1291,121,9607,4638,4969
48489,Willacy County,TX,21588,11663,9925,117.5,1388,1264,1703,1800,2137,3241,2736,2284,906,1175,1640,984,330,33.0,5194,16394,9019,7375,122.3,20975,138,0,14566,8029,6537
48491,Williamson County,TX,547604,269549,278055,96.9,36092,39524,42345,37318,30247,76589,89374,74362,30164,26849,40534,17398,6808,36.3,142323,405281,196631,208650,94.2,436477,35054,37395,371898,179528,192370
48493,Wilson County,TX,49173,24716,24457,101.1,2942,3231,3489,3599,2826,5559,6016,6995,3671,3288,4604,1924,1029,40.2,12049,37124,18553,18571,99.9,45548,690,173,36342,18188,18154
48495,Winkler County,TX,7867,4049,3818,106.1,622,693,642,776,522,916,1040,932,397,421,518,274,114,33.1,2352,5515,2825,2690,105.0,6909,393,0,4875,2408,2467
48497,Wise County,TX,66290,33406,32884,101.6,4230,4372,4898,4609,3729,8134,8100,9197,4893,4277,6169,2717,965,38.3,16461,49829,24952,24877,100.3,61993,948,338,46381,22999,23382
48499,Wood County,TX,44366,22059,22307,98.9,2145,2486,2423,2714,2344,4187,4317,5143,3468,3281,6858,3723,1277,47.9,8615,35751,17582,18169,96.8,39622,2224,286,34906,17127,17779
48501,Yoakum County,TX,8631,4480,4151,107.9,790,913,694,707,654,1108,1058,785,534,397,659,232,100,30.3,2851,5780,2933,2847,103.0,8311,38,4,4261,2094,2167
48503,Young County,TX,18036,8785,9251,95.0,1060,1236,1338,1167,762,2126,2022,2163,1305,1176,1947,1153,581,41.1,4376,13660,6681,6979,95.7,17264,379,48,12913,6350,6563
48505,Zapata County,TX,14304,7095,7209,98.4,1328,1706,1034,985,1209,1757,1726,1453,574,557,1092,627,256,29.5,4796,9508,4572,4936,92.6,13405,0,112,6985,3565,3420
48507,Zavala County,TX,12039,6221,5818,106.9,890,1108,997,800,1151,1466,1535,1260,676,491,979,470,216,32.9,3556,8483,4370,4113,106.2,11469,40,11,7915,4047,3868
49001,Beaver County,UT,6517,3362,3155,106.6,611,485,654,580,358,727,788,618,382,391,565,263,95,33.0,2138,4379,2259,2120,106.6,6103,0,19,4091,2124,1967
49003,Box Elder County,UT,53946,27550,26396,104.4,4395,5061,4942,4256,3413,6590,7072,5439,2917,3018,3880,2159,804,32.6,17190,36756,18581,18175,102.2,50233,353,422,35952,18149,17803
49005,Cache County,UT,124165,62182,61983,100.3,10791,10564,10517,11513,18110,17272,14324,10097,4573,5065,6499,3581,1259,25.2,37904,86261,42852,43409,98.7,112735,957,2550,81631,40586,41045
49007,Carbon County,UT,20308,10170,10138,100.3,1220,1556,1612,1610,1228,2425,2489,2077,1339,1343,2030,1028,351,37.5,5320,14988,7373,7615,96.8,19348,91,10,14721,7196,7525
49009,Daggett County,UT,613,348,265,131.3,24,40,50,56,41,35,74,96,85,35,62,5,10,42.5,135,478,296,182,162.6,599,1,0,478,296,182
49011,Davis County,UT,345767,174378,171389,101.7,29789,32320,32067,27341,22625,49056,50561,35923,16536,15793,20132,10192,3432,31.1,112266,233501,116176,117325,99.0,311855,4603,6143,226734,112860,113874
49013,Duchesne County,UT,20148,10280,9868,104.2,1933,1928,1889,1529,1090,2702,2751,1951,1099,982,1312,734,248,31.5,6823,13325,6793,6532,104.0,18063,90,107,12977,6590,6387
49015,Emery County,UT,10117,5168,4949,104.4,655,936,896,791,527,1067,1241,1036,594,713,998,484,179,36.2,3010,7107,3554,3553,100.0,9848,2,68,6945,3459,3486
49017,Garfield County,UT,4998,2524,2474,102.0,313,318,336,438,146,552,571,521,407,308,663,268,157,41.9,1195,3803,1946,1857,104.8,4649,10,4,3686,1921,1765
49019,Grand County,UT,9640,4934,4706,104.8,481,678,583,453,534,1218,1851,802,586,750,1088,429,187,40.2,2029,7611,3839,3772,101.8,8935,31,155,7071,3549,3522
49021,Iron County,UT,51213,25373,25840,98.2,4085,4425,3817,4563,5674,6742,5884,4685,2596,2317,4011,1992,422,29.1,14712,36501,18074,18427,98.1,47016,269,445,35370,17536,17834
49023,Juab County,UT,11301,5705,5596,101.9,967,1209,1058,1001,723,1358,1539,1101,494,530,800,348,173,30.1,3905,7396,3676,3720,98.8,10597,26,15,7254,3595,3659
49025,Kane County,UT,7484,3765,3719,101.2,432,440,511,561,215,973,781,812,478,595,1069,426,191,41.9,1763,5721,2789,2932,95.1,6976,15,48,5700,2778,2922
49027,Millard County,UT,12854,6602,6252,105.6,1025,1015,1302,965,679,1389,1492,1297,900,642,1189,654,305,35.4,4008,8846,4526,4320,104.8,11562,30,148,8250,4191,4059
49029,Morgan County,UT,11664,5983,5681,105.3,973,1103,1354,1056,706,1094,1562,1301,579,606,792,445,93,32.2,4157,7507,3738,3769,99.2,11250,90,67,7422,3703,3719
49031,Piute County,UT,1866,1016,850,119.5,108,87,171,165,35,144,237,156,114,190,268,130,61,44.5,453,1413,754,659,114.4,1823,3,0,1402,749,653
49033,Rich County,UT,2389,1126,1263,89.2,145,204,227,195,159,288,191,217,120,138,290,158,57,34.3,705,1684,768,916,83.8,2245,0,0,1561,742,819
49035,Salt Lake County,UT,1133646,569053,564593,100.8,86358,88324,86216,78852,79298,187920,164687,127573,58179,56554,72936,33734,13015,32.8,311413,822233,409967,412266,99.4,896437,21602,46123,740756,369119,371637
49037,San Juan County,UT,15302,7625,7677,99.3,1201,1357,1335,1380,965,1868,1712,1637,863,884,1222,619,259,32.2,4718,10584,5204,5380,96.7,7422,33,77,10475,5132,5343
49039,Sanpete County,UT,29850,15722,14128,111.3,1817,1847,2469,3238,2803,3526,3891,3157,1529,1494,2444,1216,419,32.6,7687,22163,11752,10411,112.9,26406,217,306,21321,11297,10024
49041,Sevier County,UT,21280,10881,10399,104.6,1515,1922,1772,1673,1184,2413,2783,2129,1112,1375,1971,1081,350,35.4,6347,14933,7537,7396,101.9,20160,137,10,14689,7403,7286
49043,Summit County,UT,41103,20964,20139,104.1,2007,2767,3505,2998,2478,4529,5470,6370,3365,2760,3386,1183,285,39.5,10207,30896,15597,15299,101.9,38221,326,724,28589,14425,14164
49045,Tooele County,UT,67397,33981,33416,101.7,5504,6273,6737,5623,4108,8912,10470,7513,3154,3127,3767,1724,485,31.4,22306,45091,22487,22604,99.5,60542,326,528,43533,21808,21725
49047,Uintah County,UT,36084,18302,17782,102.9,3187,3886,3125,2690,2290,5396,4994,3294,1885,1665,2299,863,510,30.6,12043,24041,12119,11922,101.7,31684,144,165,23652,11872,11780
49049,Utah County,UT,605490,305954,299536,102.1,57964,57483,56958,56851,76764,86468,76394,50470,20986,19356,27085,14014,4697,24.8,204549,400941,200638,200303,100.2,554930,3499,9193,375377,187657,187720
49051,Wasatch County,UT,31708,16233,15475,104.9,2423,3064,2862,2465,1895,3712,4608,3620,1980,1574,2351,855,299,34.0,10039,21669,10954,10715,102.2,29947,87,432,20513,10363,10150
49053,Washington County,UT,165811,81947,83864,97.7,11242,12728,12507,12063,10416,19517,18987,15613,8299,9803,19189,11407,4040,37.1,44160,121651,59160,62491,94.7,150104,1156,1306,116732,56612,60120
49055,Wayne County,UT,2689,1386,1303,106.4,170,156,258,245,83,252,291,291,188,203,370,138,44,40.4,739,1950,1001,949,105.5,2576,6,8,1901,959,942
49057,Weber County,UT,251498,126354,125144,101.0,19550,19669,20717,18060,17861,38605,34393,27184,14232,12503,17333,8123,3268,32.7,71662,179836,89922,89914,100.0,224216,2745,2904,170249,85010,85239
50001,Addison County,VT,36882,18302,18580,98.5,1528,1793,1806,3045,3290,3663,3933,5007,2757,2985,4398,1766,911,43.5,6341,30541,15005,15536,96.6,34625,541,663,29605,14571,15034
50003,Bennington County,VT,35746,17487,18259,95.8,1704,1850,1978,2231,2498,3472,3410,4760,3027,2768,4582,2280,1186,46.7,6805,28941,13796,15145,91.1,34210,247,360,28533,13620,14913
50005,Caledonia County,VT,30234,15192,15042,101.0,1390,1531,1887,2123,1747,3231,3353,3991,2305,2624,3761,1648,643,44.7,5936,24298,12077,12221,98.8,28959,289,156,24010,11970,12040
50007,Chittenden County,VT,162646,79812,82834,96.4,7656,7666,8516,13506,18177,22802,18771,20500,11216,10029,13885,6792,3130,36.5,29141,133505,64626,68879,93.8,146712,4445,6519,127481,61687,65794
50009,Essex County,VT,6200,3121,3079,101.4,264,301,313,339,250,529,620,909,516,592,930,461,176,50.9,1094,5106,2552,2554,99.9,5984,61,30,5028,2511,2517
50011,Franklin County,VT,49116,24403,24713,98.7,2953,3482,2531,3066,2768,6116,6196,7102,3703,3556,4710,1929,1004,40.4,10959,38157,18845,19312,97.6,46504,261,271,37733,18613,19120
50013,Grand Isle County,VT,7022,3489,3533,98.8,302,400,292,376,381,739,748,1046,609,728,988,335,78,48.2,1234,5788,2872,2916,98.5,6628,58,36,5712,2839,2873
50015,Lamoille County,VT,25318,12686,12632,100.4,1288,1491,1528,1612,1620,3249,3182,3393,1738,1981,2556,1150,530,40.8,5167,20151,10079,10072,100.1,24145,308,205,19765,9843,9922
50017,Orange County,VT,28908,14418,14490,99.5,1369,1468,1504,1727,1624,3078,3214,3970,2617,2411,3769,1542,615,46.6,5346,23562,11595,11967,96.9,27937,200,66,23385,11515,11870
50019,Orleans County,VT,26901,13512,13389,100.9,1295,1358,1581,1489,1413,2995,3080,3571,1851,2321,3622,1673,652,45.8,5210,21691,10837,10854,99.8,25925,150,77,21275,10665,10610
50021,Rutland County,VT,58892,28933,29959,96.6,2620,2720,3190,3918,3744,6228,5979,8015,4868,5063,7630,3423,1494,46.5,10536,48356,23610,24746,95.4,56865,517,672,47843,23439,24404
50023,Washington County,VT,58350,28845,29505,97.8,2791,2912,3357,3875,3665,6468,7001,8159,4613,4429,6694,3131,1255,43.7,11082,47268,23214,24054,96.5,55952,517,492,46687,22974,23713
50025,Windham County,VT,42823,20800,22023,94.4,1946,2375,2000,2366,2324,4602,4588,5750,3660,3834,5829,2443,1106,47.6,7719,35104,16926,18178,93.1,40570,502,432,34473,16671,17802
50027,Windsor County,VT,55275,27097,28178,96.2,2462,2713,3013,2876,2679,5861,6081,7563,4491,4979,7475,3802,1280,48.0,10084,45191,21964,23227,94.6,52867,406,482,44291,21590,22701
51001,Accomack County,VA,32673,15934,16739,95.2,1882,1943,1923,1684,1734,3469,3396,3884,2754,2580,4372,2086,966,45.9,6914,25759,12233,13526,90.4,22282,9331,265,23995,11244,12751
51003,Albemarle County,VA,107405,51363,56042,91.7,5783,6212,5910,9552,7011,13847,12415,12986,7286,7063,10954,5654,2732,39.1,21723,85682,40381,45301,89.1,87831,10245,5590,79994,37404,42590
51005,Alleghany County,VA,15157,7367,7790,94.6,673,856,742,893,765,1576,1525,2079,1173,1268,2030,1064,513,48.1,2864,12293,5869,6424,91.4,14012,881,16,12199,5816,6383
51007,Amelia County,VA,12953,6580,6373,103.2,763,962,556,876,513,1450,1353,1882,1417,698,1490,673,320,45.1,2776,10177,4977,5200,95.7,9824,2745,0,10119,4944,5175
51009,Amherst County,VA,31775,15290,16485,92.8,1724,1507,2003,1816,2002,3417,3500,4399,2566,2309,3739,2056,737,44.8,6237,25538,12154,13384,90.8,24381,5709,162,25299,12062,13237
51011,Appomattox County,VA,15707,7599,8108,93.7,894,907,923,1080,789,1775,1740,2101,1116,1199,1845,992,346,42.6,3350,12357,5971,6386,93.5,12263,3105,12,12234,5869,6365
51013,Arlington County,VA,233464,116785,116679,100.1,13874,11710,10454,8763,15684,57586,38545,29416,12685,10282,15018,6486,2961,34.7,41567,191897,95556,96341,99.2,166912,21360,23959,166501,83047,83454
51015,Augusta County,VA,75079,38267,36812,104.0,3408,3511,4709,4325,4017,8612,8908,10699,5924,5598,8923,4895,1550,45.1,14370,60709,30909,29800,103.7,69533,3195,460,59705,30427,29278
51017,Bath County,VA,4307,2201,2106,104.5,204,191,178,193,393,500,369,659,248,407,483,362,120,47.8,724,3583,1754,1829,95.9,3933,130,15,3503,1689,1814
51019,Bedford County,VA,78376,38462,39914,96.4,3709,4532,4482,4684,4278,7714,8391,11500,6220,6523,9773,4876,1694,46.3,15803,62573,30525,32048,95.2,70090,5384,943,61685,30145,31540
51021,Bland County,VA,6388,3564,2824,126.2,275,325,242,306,295,772,846,955,475,459,873,413,152,46.4,1034,5354,2959,2395,123.5,6066,243,10,5343,2948,2395
51023,Botetourt County,VA,33343,16365,16978,96.4,1419,1590,2094,2098,1630,3244,3386,5158,2797,2625,4357,2229,716,47.2,6491,26852,13154,13698,96.0,31393,994,223,26586,13026,13560
51025,Brunswick County,VA,16520,8843,7677,115.2,709,620,912,1137,837,2260,2078,2045,1464,1006,1942,1002,508,43.3,2757,13763,7439,6324,117.6,6931,8996,85,13562,7322,6240
51027,Buchanan County,VA,21788,10958,10830,101.2,864,1123,1199,1122,1117,2495,2458,3243,1818,1680,2767,1567,335,46.8,3930,17858,8924,8934,99.9,20678,592,225,17779,8890,8889
51029,Buckingham County,VA,17059,9363,7696,121.7,755,732,1076,872,950,2268,2173,2489,1388,1072,2000,1001,283,43.5,3131,13928,7823,6105,128.1,10506,5885,28,13822,7726,6096
51031,Campbell County,VA,55225,26711,28514,93.7,2829,3117,2994,3304,3137,7377,6260,7392,4218,3788,6200,3101,1508,43.0,11015,44210,21231,22979,92.4,44982,7735,506,43552,20890,22662
51033,Caroline County,VA,30381,15102,15279,98.8,2153,1979,1864,1812,2197,3417,3887,4068,2187,1958,2951,1417,491,40.1,6994,23387,11566,11821,97.8,19820,8211,273,22865,11353,11512
51035,Carroll County,VA,29801,15004,14797,101.4,1495,1373,1685,1665,1347,3138,3174,4176,2175,2482,4112,2279,700,47.6,5626,24175,11951,12224,97.8,29012,213,17,23869,11810,12059
51036,Charles City County,VA,7014,3430,3584,95.7,284,248,340,358,325,681,665,1114,701,620,1020,513,145,50.8,1086,5928,2848,3080,92.5,3066,3187,67,5841,2828,3013
51037,Charlotte County,VA,12040,5926,6114,96.9,598,651,873,789,680,1120,1228,1616,921,930,1480,779,375,46.2,2671,9369,4534,4835,93.8,8415,3371,48,9356,4529,4827
51041,Chesterfield County,VA,343551,165585,177966,93.0,20626,22685,23658,24558,20980,41017,46119,48655,24336,21373,31866,12555,5123,38.9,82073,261478,123290,138188,89.2,230914,79347,11858,248155,116390,131765
51043,Clarke County,VA,14423,7321,7102,103.1,638,846,832,945,804,1277,1507,2200,1296,1088,1702,777,511,47.0,2980,11443,5662,5781,97.9,12951,777,102,11239,5517,5722
51045,Craig County,VA,5110,2378,2732,87.0,303,318,163,206,346,728,427,699,346,486,658,415,15,46.3,955,4155,1918,2237,85.7,5040,6,0,4155,1918,2237
51047,Culpeper County,VA,51101,25557,25544,100.1,3288,3461,3743,3444,2819,5814,6906,7008,3461,3295,4749,2405,708,39.2,12641,38460,19203,19257,99.7,38697,7404,855,36393,18245,18148
51049,Cumberland County,VA,9824,4847,4977,97.4,460,452,635,591,581,1105,1050,1345,931,523,1379,510,262,45.6,1947,7877,3761,4116,91.4,6235,2960,122,7877,3761,4116
51051,Dickenson County,VA,14756,7472,7284,102.6,727,728,899,755,797,1665,1844,1929,1175,1077,1853,907,400,44.7,2887,11869,5994,5875,102.0,14476,84,18,11827,5974,5853
51053,Dinwiddie County,VA,28485,13993,14492,96.6,1507,1555,1757,1906,1259,3654,3441,4126,2457,1939,2926,1584,374,43.2,5836,22649,10930,11719,93.3,18401,9064,252,22216,10705,11511
51057,Essex County,VA,10998,4970,6028,82.4,640,512,739,441,783,1006,1258,1379,953,844,1472,703,268,46.3,2225,8773,3971,4802,82.7,6115,4319,68,8714,3961,4753
51059,Fairfax County,VA,1145862,568173,577689,98.4,74004,75019,75621,72716,68441,153824,165486,165493,76416,68919,91595,41758,16570,38.0,270215,875647,429775,445872,96.4,701055,112371,219697,735115,362768,372347
51061,Fauquier County,VA,69728,34507,35221,98.0,3993,4175,4962,4819,3710,7547,8544,10462,5551,4681,6791,3223,1270,41.3,16317,53411,26106,27305,95.6,60352,5170,1169,51213,24980,26233
51063,Floyd County,VA,15704,7896,7808,101.1,743,756,906,968,712,1558,1821,2222,1184,1297,2070,1034,433,47.2,3068,12636,6277,6359,98.7,14967,240,28,12395,6122,6273
51065,Fluvanna County,VA,26594,12217,14377,85.0,1187,1572,1577,1743,1230,2903,3656,3764,1818,1982,3001,1669,492,43.4,5365,21229,9400,11829,79.5,21348,3787,318,20836,9230,11606
51067,Franklin County,VA,56187,27578,28609,96.4,2612,3179,2890,3657,3027,5637,5542,7867,4359,4620,7822,3927,1048,47.2,10797,45390,22047,23343,94.4,50056,4224,298,44782,21807,22975
51069,Frederick County,VA,86415,43042,43373,99.2,5148,5307,5938,5379,4959,10314,10775,12445,6372,5264,8445,4398,1671,40.7,19941,66474,32777,33697,97.3,78403,3405,1174,63327,31113,32214
51071,Giles County,VA,16772,8222,8550,96.2,868,1081,873,904,943,1795,1970,2447,1137,1184,2102,881,587,44.7,3467,13305,6485,6820,95.1,16206,361,22,13226,6464,6762
51073,Gloucester County,VA,37222,18173,19049,95.4,1885,2084,1948,1993,2261,4354,4184,5514,3337,2741,4110,2226,585,44.9,7304,29918,14509,15409,94.2,32729,3341,282,29740,14451,15289
51075,Goochland County,VA,22865,11347,11518,98.5,841,996,1326,1377,1199,2105,2530,3551,1962,2036,3184,1278,480,48.3,4060,18805,9235,9570,96.5,18355,3655,297,18504,9091,9413
51077,Grayson County,VA,15742,8070,7672,105.2,692,674,800,740,835,1708,1738,2327,1179,1269,2134,1274,372,48.1,2657,13085,6678,6407,104.2,14554,893,55,12856,6552,6304
51079,Greene County,VA,19519,9537,9982,95.5,1109,1427,1276,1299,858,2537,2389,2727,1203,1462,2039,933,260,39.6,4698,14821,7117,7704,92.4,16926,1052,332,14311,6821,7490
51081,Greensville County,VA,11525,7256,4269,170.0,449,508,580,421,772,2098,1499,1993,800,695,1072,529,109,40.7,1806,9719,6356,3363,189.0,4350,6844,7,9586,6259,3327
51083,Halifax County,VA,34552,16645,17907,93.0,1875,1866,2019,2108,1825,3448,3546,4504,2776,2488,4593,2339,1165,46.5,7064,27488,12919,14569,88.7,21150,11959,276,27124,12677,14447
51085,Hanover County,VA,105537,51736,53801,96.2,5256,6157,7381,7582,6129,10645,12661,15793,8346,7475,10932,5062,2118,42.7,23371,82166,39623,42543,93.1,90541,9874,1637,80725,38805,41920
51087,Henrico County,VA,327535,155240,172295,90.1,20115,20352,21608,19774,18722,46872,43927,44703,22137,20240,28568,13409,7108,38.8,75033,252502,116858,135644,86.2,184326,97414,27171,233260,107002,126258
51089,Henry County,VA,51308,24817,26491,93.7,2404,2841,2938,2723,2571,5193,5380,7176,4218,3760,6553,4236,1315,47.6,9996,41312,19574,21738,90.0,37232,11649,322,40715,19200,21515
51091,Highland County,VA,2204,1062,1142,93.0,85,67,74,43,62,156,178,220,183,279,509,293,55,60.9,258,1946,975,971,100.4,2189,0,0,1946,975,971
51093,Isle of Wight County,VA,36627,17941,18686,96.0,1892,2266,2112,2203,1869,3990,4307,5177,3044,2953,4051,2181,582,44.3,7656,28971,14051,14920,94.2,26425,8248,349,28483,13846,14637
51095,James City County,VA,74916,36120,38796,93.1,3586,4121,4570,4579,3638,7271,8305,9680,5006,5764,10365,5807,2224,46.5,15089,59827,28517,31310,91.1,60263,9846,1855,58005,27698,30307
51097,King and Queen County,VA,7042,3523,3519,100.1,371,424,310,382,333,635,868,1016,589,486,1038,484,106,46.7,1365,5677,2856,2821,101.2,4755,1867,0,5633,2812,2821
51099,King George County,VA,26229,13213,13016,101.5,1614,1886,2024,1626,1716,3163,3662,3845,1740,1598,2052,888,415,37.4,6647,19582,9840,9742,101.0,20501,4288,351,19347,9698,9649
51101,King William County,VA,16688,8160,8528,95.7,920,1249,968,1175,873,2113,2109,2326,1260,1078,1514,826,277,40.3,3776,12912,6206,6706,92.5,13181,2741,201,12823,6189,6634
51103,Lancaster County,VA,10724,5034,5690,88.5,430,530,401,456,286,880,909,1096,850,1007,2021,1281,577,57.3,1640,9084,4210,4874,86.4,7299,3305,90,8986,4141,4845
51105,Lee County,VA,23948,12530,11418,109.7,1087,1146,1380,1096,1234,3082,2993,3357,2108,1491,2916,1614,444,44.9,4422,19526,10207,9319,109.5,22408,978,63,19324,10019,9305
51107,Loudoun County,VA,395134,195769,199365,98.2,28307,32600,33108,27494,20029,47417,67881,62513,23295,16875,21600,10459,3556,36.2,112621,282513,138725,143788,96.5,256660,29906,73381,245974,120591,125383
51109,Louisa County,VA,36040,17679,18361,96.3,2006,2319,1851,1796,1848,4132,4144,4978,2812,3100,4466,2029,559,44.8,7349,28691,14023,14668,95.6,28710,5359,208,28122,13722,14400
51111,Lunenburg County,VA,12282,6302,5980,105.4,562,467,729,692,848,1264,1546,1609,846,1082,1549,734,354,45.3,2233,10049,5313,4736,112.2,7764,3830,340,9731,5125,4606
51113,Madison County,VA,13170,6403,6767,94.6,625,800,826,720,618,1615,1300,1725,1061,1031,1638,950,261,45.6,2712,10458,5081,5377,94.5,11259,1087,111,10267,4960,5307
51115,Mathews County,VA,8788,4382,4406,99.5,333,227,298,646,365,694,866,1054,558,1006,1614,861,266,54.5,1293,7495,3616,3879,93.2,7720,777,53,7492,3616,3876
51117,Mecklenburg County,VA,30728,14889,15839,94.0,1557,1341,1893,1581,1636,3064,3072,3892,2429,2541,4415,2354,953,48.4,5812,24916,11958,12958,92.3,19193,10891,29,24567,11772,12795
51119,Middlesex County,VA,10675,5202,5473,95.0,428,572,453,461,390,1000,828,1364,917,945,1879,1122,316,53.9,1726,8949,4343,4606,94.3,8358,1485,9,8893,4308,4585
51121,Montgomery County,VA,98140,50664,47476,106.7,4314,3923,4496,13267,16176,13861,9978,10376,4293,5483,6985,3664,1324,29.0,15241,82899,42944,39955,107.5,83960,4449,6494,78058,40352,37706
51125,Nelson County,VA,14831,7243,7588,95.5,663,888,783,681,725,1290,1417,1818,1131,1582,2452,1106,295,51.4,2754,12077,5754,6323,91.0,12539,1921,33,11809,5562,6247
51127,New Kent County,VA,21686,10870,10816,100.5,1202,1241,1353,1219,972,2552,2868,3290,1645,1760,2440,934,210,43.3,4475,17211,8590,8621,99.6,17653,2603,243,17015,8545,8470
51131,Northampton County,VA,11885,5718,6167,92.7,629,543,851,553,605,1145,1125,1320,1040,981,1776,782,535,49.0,2364,9521,4461,5060,88.2,7371,3953,123,9242,4331,4911
51133,Northumberland County,VA,12190,5931,6259,94.8,361,721,518,450,330,899,853,1476,697,1412,2582,1441,450,58.9,1812,10378,5016,5362,93.5,8605,3331,16,10292,4978,5314
51135,Nottoway County,VA,15433,8471,6962,121.7,820,887,787,935,991,2146,1811,2055,1036,1040,1607,881,437,40.6,2993,12440,6851,5589,122.6,8815,6276,46,12101,6666,5435
51137,Orange County,VA,36010,17712,18298,96.8,2035,2337,2212,2269,1906,3818,4399,4799,2763,2365,4100,2424,583,42.0,7949,28061,13580,14481,93.8,29344,4622,341,27263,13264,13999
51139,Page County,VA,23788,11754,12034,97.7,1152,1138,1645,1302,1163,2599,2777,3501,1920,1625,2886,1710,370,45.4,4827,18961,9323,9638,96.7,22671,327,103,18794,9217,9577
51141,Patrick County,VA,17748,8812,8936,98.6,789,886,883,764,879,1598,1770,2680,1462,1395,2580,1571,491,49.9,3127,14621,7181,7440,96.5,16354,1051,72,14548,7154,7394
51143,Pittsylvania County,VA,61256,30113,31143,96.7,2560,3339,3413,3588,3127,6280,6726,8962,4711,5178,7876,4326,1170,47.2,11703,49553,24292,25261,96.2,46202,12307,275,48886,23922,24964
51145,Powhatan County,VA,28815,15324,13491,113.6,1291,1268,1627,1800,1525,3038,3804,4831,2366,2161,3339,1293,472,45.1,5272,23543,12560,10983,114.4,25113,2895,73,23225,12336,10889
51147,Prince Edward County,VA,22905,11329,11576,97.9,1059,901,1046,3351,3508,2257,2190,2250,1241,1419,2069,1022,592,31.5,3696,19209,9543,9666,98.7,14724,7068,194,18262,8702,9560
51149,Prince George County,VA,38114,20593,17521,117.5,2135,2049,2722,2494,2384,5927,5695,4935,2503,2147,3161,1661,301,37.0,8299,29815,16467,13348,123.4,22455,12456,565,29403,16230,13173
51153,Prince William County,VA,461423,230487,230936,99.8,34118,34774,36049,32094,29269,62840,70450,67016,28588,22216,28522,11969,3518,35.2,125851,335572,165902,169670,97.8,261230,96927,38570,287731,142928,144803
51155,Pulaski County,VA,34182,17122,17060,100.4,1606,1529,1815,1828,1833,3818,3812,5077,2777,2396,4520,2564,607,47.0,6085,28097,14033,14064,99.8,31474,1485,255,27821,13920,13901
51157,Rappahannock County,VA,7378,3743,3635,103.0,352,281,436,401,409,718,680,927,595,672,1167,506,234,50.1,1288,6090,3010,3080,97.7,6661,335,38,5896,2896,3000
51159,Richmond County,VA,8884,4857,4027,120.6,254,501,596,286,305,1206,1022,1422,582,829,869,769,243,47.3,1488,7396,4260,3136,135.8,5717,2370,30,7185,4103,3082
51161,Roanoke County,VA,93823,45121,48702,92.6,4418,5157,5750,5891,5065,10440,11338,12830,6711,6380,11255,6346,2242,43.8,18976,74847,35289,39558,89.2,82563,5571,2913,72843,34393,38450
51163,Rockbridge County,VA,22570,11227,11343,99.0,980,1228,988,1244,1119,2258,2469,2875,1846,1809,3138,1851,765,49.0,3996,18574,9168,9406,97.5,21067,737,149,18404,9124,9280
51165,Rockingham County,VA,80284,39392,40892,96.3,4533,4724,5296,5562,5233,8973,9207,10507,5726,5410,8303,4592,2218,41.5,17828,62456,30212,32244,93.7,74651,2428,578,60328,29056,31272
51167,Russell County,VA,27141,13306,13835,96.2,1264,1264,1673,1519,1420,2866,3218,3758,2297,2252,3288,1717,605,45.7,5181,21960,10781,11179,96.4,26522,274,0,21884,10768,11116
51169,Scott County,VA,21902,11075,10827,102.3,878,1014,1370,1148,1064,2360,2485,3057,1646,1725,2841,1716,598,47.3,4024,17878,8969,8909,100.7,21446,127,68,17719,8909,8810
51171,Shenandoah County,VA,43224,21301,21923,97.2,2339,2676,2518,2463,2271,4719,4834,5966,3260,3020,5178,2830,1150,44.5,9180,34044,16488,17556,93.9,40391,815,420,33026,15888,17138
51173,Smyth County,VA,30767,15161,15606,97.1,1474,1594,1827,1669,1704,3569,3545,4332,2113,2372,3637,2224,707,45.0,5982,24785,12034,12751,94.4,29419,668,212,24436,11837,12599
51175,Southampton County,VA,17880,9247,8633,107.1,872,931,1025,909,930,1760,2015,2923,1428,1614,2015,1137,321,46.9,3463,14417,7551,6866,110.0,11151,5744,44,14379,7540,6839
51177,Spotsylvania County,VA,132833,65286,67547,96.7,8253,8732,10097,9340,8024,16499,17119,19380,9502,7624,11404,5131,1728,38.2,33186,99647,48340,51307,94.2,95728,21451,3179,96215,46781,49434
51179,Stafford County,VA,146773,74067,72706,101.9,9363,10576,11303,10953,10628,19520,20339,22180,10018,7036,9623,4051,1183,35.5,38395,108378,54510,53868,101.2,98791,25929,4910,102875,52083,50792
51181,Surry County,VA,6523,3154,3369,93.6,286,294,332,358,301,810,510,977,651,591,868,372,173,49.8,1131,5392,2622,2770,94.7,3454,2897,11,5363,2622,2741
51183,Sussex County,VA,11377,6811,4566,149.2,487,439,545,587,924,1828,1460,1614,859,665,1142,626,201,41.0,1789,9588,5861,3727,157.3,4535,6288,146,9459,5780,3679
51185,Tazewell County,VA,41603,20647,20956,98.5,2194,2427,1952,2341,2221,4499,5038,5612,3318,3063,5274,2751,913,45.2,8030,33573,16551,17022,97.2,39273,1336,255,33378,16415,16963
51187,Warren County,VA,39492,19657,19835,99.1,2325,2622,2260,2574,2365,4889,4432,5993,3127,2735,3800,1777,593,41.3,8743,30749,15311,15438,99.2,35138,1702,444,29933,14935,14998
51191,Washington County,VA,54071,26584,27487,96.7,2216,2651,3045,3385,2890,5625,6292,7478,4340,4145,6972,3792,1240,46.3,9906,44165,21581,22584,95.6,51972,750,305,43828,21411,22417
51193,Westmoreland County,VA,17751,8793,8958,98.2,907,1202,785,751,915,1889,1768,2212,1032,1885,2579,1367,459,48.6,3345,14406,6949,7457,93.2,12054,4598,129,13937,6693,7244
51195,Wise County,VA,38486,20173,18313,110.2,1858,2226,2015,2337,2526,5254,4751,5070,2656,2987,4125,1859,822,41.4,7462,31024,16348,14676,111.4,35448,2112,156,30832,16239,14593
51197,Wythe County,VA,28844,14090,14754,95.5,1357,1655,1631,1638,1388,3136,3507,4230,2181,2147,3469,1755,750,45.3,5746,23098,11195,11903,94.1,27375,837,129,23040,11164,11876
51199,York County,VA,67982,33376,34606,96.4,3779,4286,5103,4803,4322,7638,9205,9073,4889,4220,6268,3168,1228,39.6,16245,51737,25277,26460,95.5,50604,9034,3833,49881,24374,25507
51510,Alexandria city,VA,157613,75954,81659,93.0,11214,7457,6424,5468,7419,34479,28953,21201,9102,8130,11217,4246,2303,36.8,28632,128981,61274,67707,90.5,98017,34287,9280,106163,50445,55718
51520,Bristol city,VA,16912,7961,8951,88.9,936,1004,861,1311,716,2173,1991,2074,1284,1106,1853,1072,531,42.2,3604,13308,6199,7109,87.2,15299,964,38,13253,6190,7063
51530,Buena Vista city,VA,6484,2776,3708,74.9,330,415,457,459,700,852,405,934,410,326,646,424,126,35.5,1344,5140,2315,2825,81.9,5784,472,123,5096,2315,2781
51540,Charlottesville city,VA,47096,22788,24308,93.7,2366,1887,2054,3205,7228,9577,5766,4895,2691,2101,3226,1417,683,31.6,7368,39728,18998,20730,91.6,33247,8844,3327,36730,17365,19365
51550,Chesapeake city,VA,239982,117267,122715,95.6,15144,16723,15894,16081,15098,33978,32499,32300,16611,14569,19121,8954,3010,36.9,58178,181804,87707,94097,93.2,146540,72084,7571,177045,85314,91731
51570,Colonial Heights city,VA,17428,8060,9368,86.0,1065,1050,1240,975,1004,2159,2078,2217,1121,969,1762,1249,539,40.6,3977,13451,6055,7396,81.9,13163,2673,724,13085,5864,7221
51580,Covington city,VA,5598,2680,2918,91.8,332,323,333,254,372,722,671,648,336,476,660,325,146,42.4,1147,4451,2131,2320,91.9,4596,732,65,4410,2103,2307
51590,Danville city,VA,41070,18883,22187,85.1,2419,2728,2379,2337,2670,5204,4259,4876,2878,2978,4514,2524,1304,40.9,8971,32099,14249,17850,79.8,18687,20283,483,31310,13812,17498
51595,Emporia city,VA,5442,2455,2987,82.2,272,365,645,371,274,761,651,628,317,242,426,276,214,35.4,1564,3878,1709,2169,78.8,1525,3440,14,3781,1643,2138
51600,Fairfax city,VA,23531,11444,12087,94.7,1695,1422,1329,1418,1545,3243,3164,3187,1710,1320,1974,1033,491,38.2,5249,18282,8905,9377,95.0,15955,1157,4040,15623,7643,7980
51610,Falls Church city,VA,14128,6868,7260,94.6,745,1044,1074,898,787,1752,1941,2208,958,905,1136,543,137,38.7,3524,10604,4993,5611,89.0,11213,692,1396,9651,4673,4978
51620,Franklin city,VA,8147,3640,4507,80.8,546,736,482,361,260,1103,1095,870,499,624,924,417,230,39.4,2051,6096,2628,3468,75.8,3003,4618,103,6070,2602,3468
51630,Fredericksburg city,VA,28622,12997,15625,83.2,1997,1544,1632,2409,3775,5146,3222,3008,1537,1268,1905,823,356,30.4,6005,22617,10085,12532,80.5,17839,6322,764,21013,9186,11827
51640,Galax city,VA,6517,3090,3427,90.2,332,402,536,326,167,593,908,859,406,530,760,425,273,45.0,1414,5103,2351,2752,85.4,5842,491,42,4802,2198,2604
51650,Hampton city,VA,135041,65105,69936,93.1,8279,6772,8839,8787,11859,21200,15095,15801,10039,8155,11791,5786,2638,36.2,28512,106529,50457,56072,90.0,55513,67450,3352,104489,49378,55111
51660,Harrisonburg city,VA,53273,25548,27725,92.1,2728,2568,2215,9265,9495,7510,5956,4600,2098,2060,2572,1381,825,25.4,8709,44564,21108,23456,90.0,42838,3946,2073,39009,18126,20883
51670,Hopewell city,VA,22456,10499,11957,87.8,1667,1877,1336,1484,1242,3333,2420,2794,1504,1315,2010,948,526,36.2,5764,16692,7510,9182,81.8,11435,9778,307,16392,7325,9067
51678,Lexington city,VA,7241,4112,3129,131.4,167,162,133,1755,1834,564,391,549,299,259,645,337,146,22.3,649,6592,3887,2705,143.7,6063,637,250,6438,3806,2632
51680,Lynchburg city,VA,80569,37729,42840,88.1,4885,3871,4282,8954,13653,11139,7125,7299,3836,4157,5945,3577,1846,28.3,15508,65061,29846,35215,84.8,52348,23069,1973,62569,28569,34000
51683,Manassas city,VA,41174,20657,20517,100.7,3444,3065,2939,2570,2753,6304,5941,5352,2466,2337,2575,1013,415,34.2,11059,30115,14946,15169,98.5,27233,5599,2143,24048,11861,12187
51685,Manassas Park city,VA,16986,8887,8099,109.7,1098,1266,1300,1134,1089,2693,2948,2465,791,765,892,403,142,34.7,4348,12638,6540,6098,107.2,10576,2607,1884,9613,4854,4759
51690,Martinsville city,VA,12852,5707,7145,79.9,1046,743,865,635,784,1463,1396,1684,962,877,1345,698,354,40.9,3097,9755,4275,5480,78.0,6175,5834,131,9479,4147,5332
51700,Newport News city,VA,179673,86860,92813,93.6,13117,12054,10258,12486,15315,30510,21493,20585,10760,10351,13287,6732,2725,33.5,41703,137970,65514,72456,90.4,86132,73785,5773,132397,62934,69463
51710,Norfolk city,VA,244601,127723,116878,109.3,16078,13106,12481,15854,34252,47405,27809,24671,13799,12576,15853,7184,3533,30.7,48204,196397,103233,93164,110.8,114890,100649,9029,188682,98906,89776
51720,Norton city,VA,3970,1852,2118,87.4,356,220,250,171,226,530,556,313,420,277,352,251,48,37.5,941,3029,1339,1690,79.2,3565,122,184,2992,1302,1690
51730,Petersburg city,VA,31362,14294,17068,83.7,2283,1928,1513,1534,2368,4999,3211,4008,2013,2264,3006,1576,659,38.1,6702,24660,10907,13753,79.3,5473,24044,292,24051,10565,13486
51735,Poquoson city,VA,12090,6023,6067,99.3,554,694,848,867,667,1214,1437,1712,931,792,1297,816,261,42.4,2668,9422,4603,4819,95.5,11348,136,299,9290,4573,4717
51740,Portsmouth city,VA,95097,45704,49393,92.5,7109,6322,5609,5275,7172,15658,11189,10978,6153,5858,7937,3928,1909,35.3,22277,72820,34426,38394,89.7,37831,50274,1328,71651,33749,37902
51750,Radford city,VA,17691,8388,9303,90.2,552,598,408,3151,4782,1898,1384,1527,1400,459,874,387,271,23.4,1870,15821,7372,8449,87.3,15001,1743,275,15695,7317,8378
51760,Richmond city,VA,226622,107430,119192,90.1,13352,11143,10030,14292,19926,48604,26727,25404,14339,13720,17437,7560,4088,34.0,39956,186666,87294,99372,87.8,103054,106193,4757,176853,81966,94887
51770,Roanoke city,VA,99229,47256,51973,90.9,6783,6322,5473,4912,5778,15335,12670,12862,6701,6405,9306,3963,2719,38.5,21701,77528,36351,41177,88.3,61909,28753,2956,73686,34205,39481
51775,Salem city,VA,25317,11771,13546,86.9,1135,1667,1132,2153,2122,2926,2680,3243,1742,1714,2653,1367,783,41.2,4844,20473,9526,10947,87.0,22115,1706,438,19945,9283,10662
51790,Staunton city,VA,24432,11171,13261,84.2,1450,1229,1193,1362,1554,3183,3000,2988,2027,1320,2900,1302,924,42.8,4630,19802,8759,11043,79.3,20376,2754,337,19358,8573,10785
51800,Suffolk city,VA,90093,43698,46395,94.2,5959,6129,6183,5696,5154,12182,11489,12748,6085,5704,7778,3535,1451,38.0,21903,68190,32374,35816,90.4,46357,37648,1770,67094,31935,35159
51810,Virginia Beach city,VA,450201,221324,228877,96.7,28576,27474,27795,26688,32609,74440,58680,57267,29025,25843,36542,18046,7216,36.2,100317,349884,169930,179954,94.4,298347,85609,30130,335310,163202,172108
51820,Waynesboro city,VA,22140,10836,11304,95.9,1410,1659,1423,1182,1134,3234,2813,2608,1404,1369,2087,1257,560,39.2,5158,16982,7901,9081,87.0,18025,3149,239,16372,7635,8737
51830,Williamsburg city,VA,14927,6929,7998,86.6,515,475,281,2874,3343,1799,834,1071,642,751,1288,838,216,24.9,1556,13371,5982,7389,81.0,10961,2246,963,12725,5726,6999
51840,Winchester city,VA,27897,13694,14203,96.4,1872,1882,1606,2226,1775,3704,3239,3958,1594,1598,2534,1339,570,38.1,6398,21499,10348,11151,92.8,22878,2808,624,19103,9073,10030
53001,Adams County,WA,19594,9980,9614,103.8,1921,1969,1994,1534,1463,2503,2192,1984,946,950,1287,620,231,27.9,6895,12699,6435,6264,102.7,12761,203,154,9314,4732,4582
53003,Asotin County,WA,22421,10868,11553,94.1,1119,1078,1621,1209,1180,2462,2531,2636,1581,1882,2885,1767,470,45.0,4576,17845,8662,9183,94.3,20731,116,192,17503,8465,9038
53005,Benton County,WA,197518,98762,98756,100.0,14065,15726,14320,13401,12046,26868,24496,23318,12631,11993,17387,8149,3118,35.8,52878,144640,71780,72860,98.5,162240,3198,5069,132773,65215,67558
53007,Chelan County,WA,76229,38219,38010,100.5,4658,5655,4659,4757,4593,9340,8791,8823,5466,5310,8199,4066,1912,40.1,18094,58135,28722,29413,97.7,61268,492,615,52761,25791,26970
53009,Clallam County,WA,75392,37128,38264,97.0,3545,3586,3563,3529,3521,7947,7610,7916,5691,6769,12693,6571,2451,50.8,12981,62411,30553,31858,95.9,66144,825,1284,60878,29827,31051
53011,Clark County,WA,473252,233959,239293,97.8,29192,32696,32573,31152,27684,62104,63247,62796,31410,29235,44666,18612,7885,38.4,114902,358350,175151,183199,95.6,400298,8409,21752,338557,165752,172805
53013,Columbia County,WA,3992,1926,2066,93.2,174,230,257,144,145,357,465,459,307,326,648,360,120,50.2,780,3212,1536,1676,91.6,3568,36,72,3090,1499,1591
53015,Cowlitz County,WA,106778,52844,53934,98.0,6435,6458,7318,6518,5792,13058,12259,13653,7535,7670,12056,5680,2346,41.3,24456,82322,40534,41788,97.0,94987,847,1365,80261,39544,40717
53017,Douglas County,WA,42023,21107,20916,100.9,2751,3582,2814,2821,2462,5101,5021,4890,2686,2666,4180,2205,844,37.1,10991,31032,15523,15509,100.1,29137,203,305,26873,13342,13531
53019,Ferry County,WA,7578,3821,3757,101.7,311,347,376,418,359,648,900,870,662,759,1246,468,214,50.3,1260,6318,3171,3147,100.8,5789,11,53,6261,3148,3113
53021,Franklin County,WA,92009,47702,44307,107.7,8353,8621,8629,7122,6209,14124,12621,9796,4279,3965,5141,2294,855,30.3,30167,61842,32398,29444,110.0,64838,2068,2016,47824,24983,22841
53023,Garfield County,WA,2230,1139,1091,104.4,112,125,132,228,16,237,221,241,164,203,289,201,61,46.1,535,1695,852,843,101.1,2037,0,71,1644,852,792
53025,Grant County,WA,95502,48538,46964,103.4,7692,8103,7967,7080,6643,12798,11227,10542,5385,5183,7779,3751,1352,32.9,28263,67239,34233,33006,103.7,65761,810,946,54948,27586,27362
53027,Grays Harbor County,WA,72779,37317,35462,105.2,3895,4150,4292,4130,3600,8517,8537,9005,5465,5889,9464,4076,1759,44.0,14936,57843,29682,28161,105.4,63802,859,1096,56098,28680,27418
53029,Island County,WA,82866,41393,41473,99.8,4649,3875,4230,3878,5697,11430,8402,8803,5512,6542,12257,5770,1821,44.2,15146,67720,33667,34053,98.9,70072,2603,4046,65616,32985,32631
53031,Jefferson County,WA,31285,15276,16009,95.4,944,1286,1034,1030,1058,2739,2570,3290,2609,3687,6995,3139,904,58.3,3906,27379,13403,13976,95.9,28425,178,516,26651,13154,13497
53033,King County,WA,2195502,1100652,1094850,100.5,128327,129876,118749,118500,132962,395519,328328,295445,137149,126315,170597,76123,37612,37.0,448094,1747408,872259,875149,99.7,1404324,141790,386404,1506511,746619,759892
53035,Kitsap County,WA,265882,135983,129899,104.7,15353,15114,15041,14780,20778,38340,30899,32298,19344,17791,29075,12916,4153,39.1,54650,211232,107982,103250,104.6,215015,7129,12876,205547,105833,99714
53037,Kittitas County,WA,45897,23167,22730,101.9,2139,2368,2113,4150,7244,5417,4545,4914,2851,2936,4374,2117,729,33.8,7901,37996,19023,18973,100.3,40611,443,729,36765,18327,18438
53039,Klickitat County,WA,21721,10928,10793,101.3,1091,1054,1322,1127,997,2117,2616,2705,1682,1884,3314,1500,312,46.9,4228,17493,8791,8702,101.0,20173,160,155,16381,8194,8187
53041,Lewis County,WA,78145,39083,39062,100.1,4586,4317,4864,4772,4087,9200,9060,9504,5694,5875,9740,4653,1793,43.1,16858,61287,30423,30864,98.6,70251,414,1024,58825,29107,29718
53043,Lincoln County,WA,10574,5345,5229,102.2,532,556,744,627,469,911,1044,1248,890,852,1559,906,236,48.4,2263,8311,4173,4138,100.8,9881,83,69,8235,4129,4106
53045,Mason County,WA,63804,33063,30741,107.6,3351,3593,3411,3298,3352,7280,7191,7349,5184,5412,9059,4009,1315,45.6,12419,51385,26464,24921,106.2,53269,800,752,49163,25275,23888
53047,Okanogan County,WA,41842,21253,20589,103.2,2585,2803,2678,2355,2211,4510,4700,4696,3143,3324,5480,2655,702,42.6,9615,32227,16227,16000,101.4,30320,186,358,28939,14422,14517
53049,Pacific County,WA,21688,10911,10777,101.2,918,1022,1010,976,912,1958,2147,2281,1849,2050,4121,1878,566,53.6,3530,18158,9026,9132,98.8,18907,76,365,17289,8564,8725
53051,Pend Oreille County,WA,13377,6742,6635,101.6,605,602,785,881,504,1175,1256,1653,1173,1311,2271,851,310,51.0,2564,10813,5459,5354,102.0,12021,49,130,10625,5369,5256
53053,Pierce County,WA,877013,437477,439536,99.5,58570,59494,54839,53447,61357,136148,114427,111099,56715,52311,71996,33251,13359,36.1,206114,670899,332112,338787,98.0,639612,59213,55571,636260,315126,321134
53055,San Juan County,WA,16788,8089,8699,93.0,479,610,691,721,577,1281,1716,1926,1558,1702,3560,1582,385,56.6,2222,14566,6978,7588,92.0,15497,149,219,13985,6675,7310
53057,Skagit County,WA,125612,62106,63506,97.8,7581,7398,8053,7245,7139,15771,14604,14633,8792,8945,15196,7477,2778,41.5,27619,97993,48055,49938,96.2,103131,1110,2388,90779,44545,46234
53059,Skamania County,WA,11753,5900,5853,100.8,509,607,702,629,501,1153,1462,1658,1017,1176,1494,661,184,46.6,2241,9512,4722,4790,98.6,10911,58,131,9291,4628,4663
53061,Snohomish County,WA,798808,400594,398214,100.6,50720,49192,51697,46336,46664,118349,112148,111682,56686,50689,64995,27894,11756,38.0,181673,617135,307367,309768,99.2,601915,24369,86121,562415,280812,281603
53063,Spokane County,WA,505505,250722,254783,98.4,30798,29860,32788,32389,34625,75313,61591,61709,33685,32906,48028,22631,9182,37.6,112328,393177,192876,200301,96.3,443791,8444,11553,382451,187436,195015
53065,Stevens County,WA,44655,22242,22413,99.2,2386,2792,2653,2643,2185,4123,4459,5527,3755,4074,6348,2801,909,46.9,9593,35062,17267,17795,97.0,39788,192,290,34523,16996,17527
53067,Thurston County,WA,279711,136855,142856,95.8,16313,17308,16537,16360,16811,40356,37233,34750,18475,18638,29229,12888,4813,39.0,60355,219356,105761,113595,93.1,227952,8826,15832,211030,102286,108744
53069,Wahkiakum County,WA,4268,2017,2251,89.6,168,215,206,184,199,242,421,491,274,458,896,413,101,55.1,701,3567,1716,1851,92.7,3877,54,79,3479,1668,1811
53071,Walla Walla County,WA,60365,30904,29461,104.9,3330,3360,3825,4762,5360,7626,6735,7052,4031,3648,5850,2953,1833,37.5,12767,47598,24316,23282,104.4,50534,1074,999,43903,22483,21420
53073,Whatcom County,WA,220821,109070,111751,97.6,11813,12157,12043,14982,23552,29542,26082,25673,13367,14289,22949,10018,4354,37.3,43252,177569,86870,90699,95.8,184006,2204,9120,167228,82201,85027
53075,Whitman County,WA,49231,25175,24056,104.7,2090,2079,2156,7554,10990,7020,4323,3685,2165,2168,2904,1446,651,24.7,7450,41781,21199,20582,103.0,40573,1084,4169,37986,18981,19005
53077,Yakima County,WA,249697,125044,124653,100.3,20304,21174,20911,18811,17060,33233,29612,27794,14216,12844,19717,9664,4357,33.0,74343,175354,86909,88445,98.3,192911,2918,2447,145237,71154,74083
54001,Barbour County,WV,16633,8170,8463,96.5,853,846,1027,1335,1310,1725,1840,2118,1319,1034,1902,1010,314,41.7,3332,13301,6441,6860,93.9,15939,146,128,13251,6412,6839
54003,Berkeley County,WV,115329,56868,58461,97.3,7147,7759,7619,6797,6579,15666,15685,16218,7975,7218,10867,4390,1409,38.8,27130,88199,43172,45027,95.9,100097,9039,1242,86476,42437,44039
54005,Boone County,WV,22368,11124,11244,98.9,1105,1396,1393,1393,1097,2232,2950,3114,1426,1987,2708,1191,376,43.5,4815,17553,8669,8884,97.6,21915,218,26,17540,8666,8874
54007,Braxton County,WV,14190,7162,7028,101.9,734,812,769,820,605,1638,1560,1892,1025,1151,1865,994,325,45.9,2797,11393,5735,5658,101.4,13757,106,0,11378,5720,5658
54009,Brooke County,WV,22459,11089,11370,97.5,977,1064,1134,1645,1363,2206,2441,2903,1837,1765,2945,1689,490,46.6,3930,18529,9057,9472,95.6,21620,392,108,18358,8990,9368
54011,Cabell County,WV,94339,46172,48167,95.9,5281,5046,5262,6318,9439,11701,11062,11064,6126,5840,9850,5286,2064,38.8,18687,75652,36458,39194,93.0,85501,4587,1283,74970,36108,38862
54013,Calhoun County,WV,7295,3523,3772,93.4,352,373,490,352,296,668,842,988,641,577,1036,530,150,48.1,1437,5858,2911,2947,98.8,7223,3,0,5811,2911,2900
54015,Clay County,WV,8709,4338,4371,99.2,493,520,601,560,460,790,1030,1160,648,699,1024,630,94,44.1,1962,6747,3351,3396,98.7,8658,1,0,6747,3351,3396
54017,Doddridge County,WV,8560,4739,3821,124.0,328,396,324,741,411,933,1125,1271,685,584,1078,569,115,45.3,1342,7218,4030,3188,126.4,8178,137,45,7177,4022,3155
54019,Fayette County,WV,43576,21916,21660,101.2,2499,2538,2489,2410,2214,4750,5358,5701,3064,3651,5268,2508,1126,44.3,9009,34567,17343,17224,100.7,40722,2274,24,34366,17249,17117
54021,Gilmer County,WV,8041,4725,3316,142.5,386,379,259,639,813,1025,1146,993,574,495,724,487,121,39.2,1208,6833,4013,2820,142.3,6694,966,75,6653,3888,2765
54023,Grant County,WV,11616,5800,5816,99.7,587,550,652,714,544,1233,1265,1582,814,897,1639,816,323,46.2,2193,9423,4710,4713,99.9,11262,181,23,9423,4710,4713
54025,Greenbrier County,WV,35155,17088,18067,94.6,1818,1665,2178,1865,1742,3926,4129,4501,2558,2822,4585,2389,977,45.5,6912,28243,13658,14585,93.6,33010,996,217,28026,13563,14463
54027,Hampshire County,WV,23309,11874,11435,103.8,1110,1343,1152,1314,1258,2367,2534,3356,1774,2028,3155,1319,599,47.2,4476,18833,9529,9304,102.4,22627,258,104,18766,9483,9283
54029,Hancock County,WV,29383,14178,15205,93.2,1403,1451,1701,1576,1490,2927,3338,4032,2455,2378,3721,1876,1035,46.8,5616,23767,11349,12418,91.4,27901,578,136,23687,11315,12372
54031,Hardy County,WV,13805,7122,6683,106.6,746,916,650,743,646,1365,1627,2088,859,1146,1778,906,335,45.7,2839,10966,5565,5401,103.0,12618,768,227,10737,5411,5326
54033,Harrison County,WV,67908,33109,34799,95.1,3887,3800,4369,3901,3677,8080,8405,9078,4721,5115,7319,3861,1695,42.2,14546,53362,25692,27670,92.9,64720,1069,396,53130,25574,27556
54035,Jackson County,WV,28907,14345,14562,98.5,1554,1958,1591,1738,1474,3192,3448,3919,2046,2223,3160,1750,854,43.7,6221,22686,11064,11622,95.2,28219,109,97,22593,11008,11585
54037,Jefferson County,WV,56506,27972,28534,98.0,3104,3465,3844,3791,3181,6252,7404,8765,4003,3916,5561,2550,670,41.1,12687,43819,21408,22411,95.5,49263,3504,769,42760,20928,21832
54039,Kanawha County,WV,183279,88317,94962,93.0,9907,10701,9866,10141,10085,22473,22200,23561,13564,14172,21266,10679,4664,43.4,36872,146407,69771,76636,91.0,162196,13154,2208,145120,69033,76087
54041,Lewis County,WV,16166,8120,8046,100.9,991,813,1084,830,845,1847,1923,2268,1145,1151,1952,879,438,43.8,3428,12738,6359,6379,99.7,15744,29,81,12654,6308,6346
54043,Lincoln County,WV,20850,10366,10484,98.9,1197,1417,1310,1057,1131,2213,2678,2911,1409,1637,2337,1242,311,43.2,4692,16158,7941,8217,96.6,20495,39,24,16124,7941,8183
54045,Logan County,WV,33154,16437,16717,98.3,1880,1459,2283,1759,1707,3740,4420,4356,2559,2561,4012,1693,725,43.8,6789,26365,12981,13384,97.0,32050,584,29,26336,12964,13372
54047,McDowell County,WV,18661,9595,9066,105.8,1027,1088,1058,947,878,2077,2259,2409,1395,1648,2330,1183,362,45.0,3828,14833,7554,7279,103.8,16628,1551,13,14684,7409,7275
54049,Marion County,WV,56355,27767,28588,97.1,3246,3186,2981,3637,4621,6555,6657,7160,3470,4072,6249,2968,1553,41.1,11289,45066,21905,23161,94.6,52748,1975,268,44825,21697,23128
54051,Marshall County,WV,31308,15516,15792,98.3,1590,1538,1935,1651,1598,3407,3654,4255,2337,2636,4034,1883,790,45.7,6130,25178,12433,12745,97.6,30512,270,79,25111,12416,12695
54053,Mason County,WV,26820,13022,13798,94.4,1488,1675,1560,1497,1328,2909,3270,3481,2149,1994,3148,1760,561,44.2,5734,21086,9947,11139,89.3,26092,112,172,21007,9947,11060
54055,Mercer County,WV,59919,28419,31500,90.2,3426,3916,2860,3531,3690,6974,6781,7430,3841,4696,7428,3729,1617,43.1,12296,47623,22215,25408,87.4,54664,3838,362,47455,22142,25313
54057,Mineral County,WV,27167,13617,13550,100.5,1366,1351,1675,1861,1545,3015,2930,3810,2109,1725,3427,1723,630,44.5,5470,21697,10680,11017,96.9,25742,925,116,21616,10644,10972
54059,Mingo County,WV,24290,11851,12439,95.3,1454,1230,1725,1428,1205,2756,3069,3286,1788,1941,2794,1317,297,42.8,5421,18869,8990,9879,91.0,23258,568,19,18869,8990,9879
54061,Monongalia County,WV,105474,54477,50997,106.8,5289,4466,4871,8574,16721,17822,12783,10908,5831,5382,7838,3572,1417,31.7,17286,88188,45471,42717,106.4,94397,3781,3644,84337,43231,41106
54063,Monroe County,WV,13401,6657,6744,98.7,614,738,781,742,554,1389,1478,1809,1053,926,1931,976,410,48.0,2625,10776,5311,5465,97.2,13027,125,0,10681,5243,5438
54065,Morgan County,WV,17709,8755,8954,97.8,803,763,1064,1172,694,1749,1889,2639,1315,1588,2451,1281,301,47.9,3269,14440,7158,7282,98.3,16914,193,0,14394,7158,7236
54067,Nicholas County,WV,25078,12358,12720,97.2,1280,1596,1393,1254,1258,2728,2978,3314,1651,2166,3279,1576,605,45.1,5109,19969,9757,10212,95.5,24351,214,56,19849,9684,10165
54069,Ohio County,WV,42143,20307,21836,93.0,2173,2078,2386,2829,2927,4733,4692,5007,3059,3336,4963,2485,1475,43.6,8064,34079,16250,17829,91.1,39166,1641,300,33883,16180,17703
54071,Pendleton County,WV,7001,3585,3416,104.9,315,326,398,300,385,618,693,900,620,594,966,598,288,50.8,1279,5722,2898,2824,102.6,6689,233,0,5709,2898,2811
54073,Pleasants County,WV,7482,4045,3437,117.7,339,345,407,512,458,851,959,1091,616,511,829,347,217,43.6,1459,6023,3275,2748,119.2,7196,21,0,6023,3275,2748
54075,Pocahontas County,WV,8450,4336,4114,105.4,405,334,476,413,359,917,914,1110,722,701,1223,659,217,49.1,1462,6988,3602,3386,106.4,8334,37,9,6940,3570,3370
54077,Preston County,WV,33683,17286,16397,105.4,1742,2109,1570,1662,1792,4455,4337,4618,2346,2493,3951,1904,704,42.7,6510,27173,13936,13237,105.3,31044,1717,85,26856,13705,13151
54079,Putnam County,WV,56610,27875,28735,97.0,3074,3521,3762,3515,2792,6577,7452,7792,4070,3930,6061,3054,1010,41.8,12749,43861,21282,22579,94.3,54592,801,438,43715,21246,22469
54081,Raleigh County,WV,75252,37679,37573,100.3,4009,4400,4716,3962,4279,8991,9933,9252,4735,5898,9072,4209,1796,42.2,15678,59574,29595,29979,98.7,66312,5816,731,59011,29325,29686
54083,Randolph County,WV,28930,14844,14086,105.4,1495,1784,1301,1715,1675,3559,3231,3847,1922,2288,3568,1818,727,43.7,5540,23390,12046,11344,106.2,27883,620,160,23290,11966,11324
54085,Ritchie County,WV,9844,4884,4960,98.5,464,496,652,504,529,944,1070,1386,828,718,1344,680,229,46.8,1954,7890,3887,4003,97.1,9592,27,0,7862,3874,3988
54087,Roane County,WV,14020,6923,7097,97.5,671,731,1016,875,609,1375,1632,1896,1222,1010,1774,940,269,45.8,2995,11025,5449,5576,97.7,13723,9,22,11005,5449,5556
54089,Summers County,WV,12848,5916,6932,85.3,483,549,700,582,568,1363,1669,1724,1068,1027,1805,956,354,49.1,2157,10691,4816,5875,82.0,11967,586,0,10672,4807,5865
54091,Taylor County,WV,16864,8490,8374,101.4,884,871,1087,782,856,2071,2108,2396,1123,1353,1961,892,480,44.1,3424,13440,6746,6694,100.8,16245,218,52,13346,6734,6612
54093,Tucker County,WV,6982,3512,3470,101.2,316,217,343,374,354,720,757,1006,527,604,1022,560,182,49.3,1120,5862,2925,2937,99.6,6799,33,38,5862,2925,2937
54095,Tyler County,WV,8811,4394,4417,99.5,447,464,510,509,433,868,963,1260,745,693,1115,638,166,47.0,1735,7076,3504,3572,98.1,8602,32,62,7004,3461,3543
54097,Upshur County,WV,24502,12201,12301,99.2,1333,1423,1420,1754,1952,2674,2629,3135,1519,1820,2822,1475,546,41.7,5040,19462,9615,9847,97.6,23741,500,43,19379,9551,9828
54099,Wayne County,WV,40303,19608,20695,94.7,2075,2284,2497,2375,2192,4348,4937,5463,3281,2640,4781,2397,1033,44.1,8420,31883,15408,16475,93.5,39330,347,113,31734,15314,16420
54101,Webster County,WV,8386,4171,4215,99.0,414,461,499,456,406,812,926,1154,672,679,1164,504,239,47.2,1685,6701,3323,3378,98.4,8352,2,0,6701,3323,3378
54103,Wetzel County,WV,15436,7469,7967,93.7,776,742,1083,895,835,1556,1672,2076,1313,973,1932,1205,378,46.0,3186,12250,5935,6315,94.0,15093,164,0,12244,5935,6309
54105,Wirt County,WV,5798,2936,2862,102.6,292,315,415,369,178,648,671,800,572,401,687,395,55,45.4,1236,4562,2293,2269,101.1,5762,26,0,4562,2293,2269
54107,Wood County,WV,84960,41052,43908,93.5,4835,4422,5559,4919,4653,9527,10165,11550,6211,6175,9746,5171,2027,43.5,17940,67020,32053,34967,91.7,81720,1208,445,66721,31910,34811
54109,Wyoming County,WV,21281,10477,10804,97.0,1076,1057,1406,1297,1019,2179,2733,2730,1422,1939,2811,1087,525,44.6,4428,16853,8176,8677,94.2,20716,262,54,16829,8152,8677
55001,Adams County,WI,20094,10788,9306,115.9,651,767,965,819,786,1764,2038,2714,1791,2026,3500,1761,512,53.8,2918,17176,9278,7898,117.5,18621,552,132,16908,9064,7844
55003,Ashland County,WI,15617,7905,7712,102.5,840,955,1072,1102,988,1584,1775,1902,1232,1211,1734,920,302,42.0,3469,12148,6059,6089,99.5,13094,117,73,12072,6001,6071
55005,Barron County,WI,45229,22554,22675,99.5,2436,2682,3054,2498,2298,4925,5015,5666,3386,3585,5536,2943,1205,44.2,9792,35437,17538,17899,98.0,42809,718,314,35001,17390,17611
55007,Bayfield County,WI,14993,7636,7357,103.8,623,793,694,739,645,1234,1351,1990,1295,1601,2558,1167,303,52.2,2602,12391,6289,6102,103.1,12904,130,72,12295,6252,6043
55009,Brown County,WI,261368,129618,131750,98.4,16870,18548,16590,17426,17308,35458,33055,34305,18827,15443,21850,11077,4611,37.4,62531,198837,97820,101017,96.8,222053,6386,8465,190196,93120,97076
55011,Buffalo County,WI,13126,6683,6443,103.7,682,652,855,735,652,1327,1426,1810,1045,1102,1602,877,361,46.6,2681,10445,5354,5091,105.2,12720,95,12,10344,5293,5051
55013,Burnett County,WI,15289,7857,7432,105.7,655,761,795,752,591,1210,1420,1959,1336,1524,2544,1397,345,52.8,2715,12574,6368,6206,102.6,13986,85,52,12517,6345,6172
55015,Calumet County,WI,49928,25024,24904,100.5,2717,3449,3593,3414,2701,5312,6690,7672,3907,3315,4255,2085,818,40.6,12113,37815,18891,18924,99.8,47224,426,1203,37429,18704,18725
55017,Chippewa County,WI,63892,33135,30757,107.7,3557,4046,4196,3624,3288,7808,8070,8636,4666,4827,6542,3031,1601,41.2,14171,49721,25934,23787,109.0,60684,1017,860,49390,25765,23625
55019,Clark County,WI,34579,17489,17090,102.3,2838,2823,2808,2517,1898,3413,3695,4177,2456,2288,3047,1757,862,37.4,10184,24395,12305,12090,101.8,33359,164,138,23840,12013,11827
55021,Columbia County,WI,57133,29290,27843,105.2,3074,3302,3641,3537,3109,6636,7131,8090,4320,4325,5919,2708,1341,42.4,12342,44791,22922,21869,104.8,54254,772,445,44153,22555,21598
55023,Crawford County,WI,16235,8459,7776,108.8,797,945,909,999,878,1706,1674,2088,1338,1227,2108,975,591,46.3,3320,12915,6710,6205,108.1,15494,323,101,12871,6704,6167
55025,Dane County,WI,536078,266443,269635,98.8,30552,30334,31282,35198,56002,83948,70445,64185,32857,30296,43356,19066,8557,35.1,110241,425837,209958,215879,97.3,449694,27781,31808,399999,195511,204488
55027,Dodge County,WI,87715,45623,42092,108.4,4057,4885,5717,5145,4768,10748,10957,12844,7248,6241,8326,4412,2367,42.5,18122,69593,36641,32952,111.2,82065,2472,571,68430,35999,32431
55029,Door County,WI,27472,13489,13983,96.5,1032,1060,1506,1252,1088,2499,2800,3307,2384,2583,4792,2314,855,53.0,4438,23034,11238,11796,95.3,26447,222,137,22685,11049,11636
55031,Douglas County,WI,43295,21760,21535,101.0,2134,2347,2654,2650,2621,5406,5219,5749,3226,3496,4627,2343,823,42.2,8631,34664,17282,17382,99.4,40205,609,538,34181,16996,17185
55033,Dunn County,WI,44759,22476,22283,100.9,2338,2525,2474,4209,5922,5065,4782,5088,2919,2612,3971,1977,877,34.7,8862,35897,17870,18027,99.1,42081,292,1223,35277,17607,17670
55035,Eau Claire County,WI,103514,51280,52234,98.2,5879,6080,5566,8036,12447,14378,11683,11292,6723,5765,9215,4411,2039,34.5,21039,82475,40277,42198,95.4,95139,1286,4222,80971,39375,41596
55037,Florence County,WI,4314,2247,2067,108.7,172,199,188,209,110,388,381,653,477,432,647,315,143,53.6,676,3638,1869,1769,105.7,4238,13,0,3620,1851,1769
55039,Fond du Lac County,WI,102597,50579,52018,97.2,5615,6267,6139,6548,6380,11947,12181,14060,7961,7134,10436,5291,2638,41.6,21949,80648,39549,41099,96.2,95232,1448,1275,78376,38299,40077
55041,Forest County,WI,8995,4529,4466,101.4,526,490,476,507,552,870,865,1137,721,797,1162,678,214,46.7,1798,7197,3616,3581,101.0,7215,77,70,7148,3591,3557
55043,Grant County,WI,51733,26853,24880,107.9,2771,3005,3108,4934,6118,5391,5262,5616,3496,3301,4619,2768,1344,36.0,10673,41060,21372,19688,108.6,49897,776,504,40616,21103,19513
55045,Green County,WI,36896,18354,18542,99.0,1908,2251,2624,2138,1929,4011,4497,5142,3169,2547,3811,1887,982,43.2,8253,28643,14148,14495,97.6,35479,219,236,28193,13911,14282
55047,Green Lake County,WI,18755,9460,9295,101.8,1059,1178,1149,1201,882,1827,1994,2401,1399,1615,2309,1189,552,45.3,4180,14575,7318,7257,100.8,18069,109,137,14267,7123,7144
55049,Iowa County,WI,23618,11865,11753,101.0,1343,1543,1583,1408,1144,2606,2727,3270,2003,1737,2586,1156,512,42.8,5417,18201,9105,9096,100.1,22860,213,160,18043,8996,9047
55051,Iron County,WI,5687,2891,2796,103.4,156,220,275,223,221,448,544,765,579,543,945,558,210,54.9,798,4889,2484,2405,103.3,5492,7,28,4859,2470,2389
55053,Jackson County,WI,20522,10956,9566,114.5,1232,1080,1391,1225,1100,2526,2362,2770,1495,1549,2209,1174,409,41.7,4499,16023,8667,7356,117.8,17953,417,87,15742,8472,7270
55055,Jefferson County,WI,84701,42338,42363,99.9,4309,4972,5404,6388,5082,9766,10576,11997,6691,5606,8318,4064,1528,41.1,18124,66577,33031,33546,98.5,79705,753,530,65021,32190,32831
55057,Juneau County,WI,26478,14142,12336,114.6,1355,1520,1497,1421,1230,2930,3158,3856,2265,1916,3140,1574,616,45.4,5330,21148,11368,9780,116.2,24826,608,147,20908,11222,9686
55059,Kenosha County,WI,168524,83347,85177,97.9,9708,10136,11938,12474,11231,21426,21352,24201,12217,10858,13478,6490,3015,38.5,39143,129381,63397,65984,96.1,144055,12757,2672,124354,60710,63644
55061,Kewaunee County,WI,20387,10316,10071,102.4,975,1113,1429,1259,1078,2077,2429,2846,1628,1515,2240,1304,494,44.3,4362,16025,8065,7960,101.3,19746,148,62,15717,7877,7840
55063,La Crosse County,WI,117894,57478,60416,95.1,6065,6443,6933,9202,13795,15108,13133,13423,7898,7216,10567,5320,2791,35.9,23451,94443,45484,48959,92.9,107194,1831,5186,93427,45031,48396
55065,Lafayette County,WI,16715,8468,8247,102.7,1056,1192,1082,1090,888,1841,1829,2101,1330,1267,1616,953,470,41.8,4077,12638,6381,6257,102.0,16270,101,89,12328,6175,6153
55067,Langlade County,WI,19146,9703,9443,102.8,937,892,1148,1161,881,1817,1992,2574,1757,1517,2439,1425,606,48.7,3687,15459,7763,7696,100.9,18246,240,42,15255,7671,7584
55069,Lincoln County,WI,27744,13922,13822,100.7,1238,1293,1525,1642,1439,2586,3187,4195,2486,2335,3208,1941,669,47.7,5166,22578,11274,11304,99.7,26854,204,109,22435,11210,11225
55071,Manitowoc County,WI,79185,39500,39685,99.5,4119,4645,4596,4656,4237,8401,9026,10858,6907,6019,8770,4837,2114,44.9,16423,62762,31052,31710,97.9,74419,869,2161,61638,30345,31293
55073,Marathon County,WI,135396,68016,67380,100.9,8010,8774,8878,8404,7719,16071,16630,18226,10008,9507,13012,6811,3346,40.7,31113,104283,52031,52252,99.6,122592,810,7873,102249,51007,51242
55075,Marinette County,WI,40391,20316,20075,101.2,1821,2217,2147,2246,1888,3972,4199,5440,3474,3617,5258,2855,1257,48.7,7679,32712,16353,16359,100.0,39045,297,135,32482,16269,16213
55077,Marquette County,WI,15304,7798,7506,103.9,753,793,931,751,627,1404,1504,2068,1377,1403,2161,1107,425,50.0,2985,12319,6240,6079,102.6,14689,104,84,12211,6183,6028
55078,Menominee County,WI,4558,2297,2261,101.6,374,360,456,454,283,529,417,483,282,329,384,173,34,32.0,1490,3068,1453,1615,90.0,496,13,7,3061,1453,1608
55079,Milwaukee County,WI,951226,460464,490762,93.8,65805,63847,63249,62697,65826,155658,121027,112496,59789,54892,71901,34555,19484,34.9,229349,721877,343618,378259,90.8,562729,251253,41067,675089,318690,356399
55081,Monroe County,WI,45771,23127,22644,102.1,3019,3220,3420,2915,2274,5430,5427,5877,3473,3179,4403,2115,1019,39.9,11640,34131,17311,16820,102.9,42540,835,416,33600,17040,16560
55083,Oconto County,WI,37646,19189,18457,104.0,1857,2091,2279,2086,1720,3671,4257,5581,3258,3273,4553,2323,697,46.9,7612,30034,15282,14752,103.6,36251,173,146,29820,15184,14636
55085,Oneida County,WI,35381,17793,17588,101.2,1598,1443,1969,1665,1586,3373,3370,4765,3174,3387,5159,2747,1145,51.3,6083,29298,14589,14709,99.2,33995,263,137,29166,14547,14619
55087,Outagamie County,WI,185700,92704,92996,99.7,11653,12898,11834,12022,11672,24554,24036,25399,13855,11228,15441,7705,3403,38.3,44067,141633,70009,71624,97.7,166701,2750,6437,138773,68452,70321
55089,Ozaukee County,WI,88597,43578,45019,96.8,4562,4710,6131,6206,5318,8534,10033,12345,7372,6342,9597,5245,2202,44.0,19066,69531,33787,35744,94.5,82886,1093,1859,68076,33009,35067
55091,Pepin County,WI,7265,3690,3575,103.2,394,432,448,377,368,704,768,964,559,658,868,534,191,46.4,1519,5746,2895,2851,101.5,7124,21,22,5691,2860,2831
55093,Pierce County,WI,41977,20790,21187,98.1,2038,2381,2862,3708,4617,4504,4784,5399,2802,2898,3643,1618,723,36.8,8755,33222,16260,16962,95.9,40164,233,535,32681,16007,16674
55095,Polk County,WI,43438,21885,21553,101.5,2146,2490,2906,2484,2137,4313,4928,6153,3654,3510,5108,2564,1045,45.6,9201,34237,17188,17049,100.8,41854,205,223,34037,17107,16930
55097,Portage County,WI,70632,35584,35048,101.5,3472,3737,4061,5784,8228,8428,7743,8383,4733,4712,6662,3418,1271,37.0,13693,56939,28535,28404,100.5,65601,577,2093,55469,27644,27825
55099,Price County,WI,13416,6806,6610,103.0,509,582,718,754,551,1123,1339,1851,1298,1326,1913,1031,421,51.6,2332,11084,5595,5489,101.9,12779,112,81,10934,5557,5377
55101,Racine County,WI,195602,96899,98703,98.2,11919,12252,13309,12633,11985,23369,23304,27110,15178,12959,18409,9312,3863,40.2,45594,150008,73450,76558,95.9,158201,22297,2523,145414,70968,74446
55103,Richland County,WI,17459,8766,8693,100.8,872,1089,1155,1104,944,1634,1866,2144,1389,1418,2099,1195,550,45.3,3784,13675,6818,6857,99.4,16672,164,126,13407,6662,6745
55105,Rock County,WI,162152,79875,82277,97.1,9850,10557,10731,10754,10033,19790,19907,21823,11620,10948,15060,7961,3118,39.5,37926,124226,60357,63869,94.5,141160,7083,2035,120265,58170,62095
55107,Rusk County,WI,14132,7074,7058,100.2,731,765,842,846,660,1184,1419,1863,1220,1254,1879,1025,444,49.0,2906,11226,5645,5581,101.1,13602,90,23,11150,5613,5537
55109,St. Croix County,WI,88732,44328,44404,99.8,5444,6275,6631,5956,4641,9940,12540,12957,6682,5637,7389,3416,1224,38.9,22349,66383,32903,33480,98.3,85085,710,869,65734,32537,33197
55111,Sauk County,WI,63922,31929,31993,99.8,3788,4452,3834,3911,3445,7487,7848,8459,4585,4639,6611,3237,1626,41.1,14610,49312,24378,24934,97.8,60126,528,387,48156,23837,24319
55113,Sawyer County,WI,16399,8356,8043,103.9,731,931,978,819,738,1421,1570,2073,1362,1635,2517,1300,324,50.3,3201,13198,6731,6467,104.1,12643,42,103,13102,6673,6429
55115,Shawano County,WI,40904,20420,20484,99.7,2250,2186,2804,2377,2000,4270,4468,5777,3236,3062,4692,2879,903,45.2,8824,32080,15948,16132,98.9,36288,164,164,31870,15850,16020
55117,Sheboygan County,WI,115178,57965,57213,101.3,6408,7059,7530,7338,6812,13381,13857,15662,8700,8313,11415,5927,2776,41.5,25703,89475,44847,44628,100.5,102224,2280,6610,87104,43882,43222
55119,Taylor County,WI,20325,10367,9958,104.1,1144,1438,1376,1273,1000,1946,2276,2709,1791,1544,2039,1271,518,43.7,4814,15511,7916,7595,104.2,19787,57,46,15369,7846,7523
55121,Trempealeau County,WI,29499,14983,14516,103.2,2074,1863,2207,1806,1500,3236,3457,3950,2080,2091,2978,1558,699,40.5,7349,22150,11200,10950,102.3,27339,166,128,21423,10827,10596
55123,Vernon County,WI,30633,15413,15220,101.3,2108,2205,2306,2018,1418,2956,3229,3788,2480,2296,3289,1689,851,41.7,7990,22643,11274,11369,99.2,29816,96,140,22465,11220,11245
55125,Vilas County,WI,21751,11037,10714,103.0,814,940,1178,932,820,1749,1835,2794,1735,2310,3820,2181,643,54.6,3584,18167,9132,9035,101.1,18895,110,131,18058,9087,8971
55127,Walworth County,WI,103074,51443,51631,99.6,5254,5913,6473,7652,9698,10773,11345,13463,8055,6817,10510,4958,2163,40.0,21757,81317,40237,41080,97.9,96079,978,977,78141,38437,39704
55129,Washburn County,WI,15688,7810,7878,99.1,686,777,999,779,602,1309,1553,2081,1317,1547,2424,1196,418,51.2,2992,12696,6277,6419,97.8,14934,120,100,12628,6241,6387
55131,Washington County,WI,134925,66936,67989,98.5,7141,8593,8545,8510,6958,14116,16542,20511,11512,8950,13627,6786,3134,43.2,29961,104964,51918,53046,97.9,127872,1815,1762,103858,51274,52584
55133,Waukesha County,WI,400475,196972,203503,96.8,20561,23189,26145,26467,21974,41738,48921,57023,32246,29797,41298,21505,9611,43.2,86890,313585,152488,161097,94.7,369238,6448,14193,305713,148401,157312
55135,Waupaca County,WI,51245,26237,25008,104.9,2424,2863,3230,3027,2566,5369,5896,7127,4330,3962,5590,3159,1702,45.5,10528,40717,20676,20041,103.2,49301,347,224,40171,20395,19776
55137,Waushara County,WI,24193,12742,11451,111.3,1171,1148,1338,1236,1025,2433,2530,3397,2104,2056,3386,1685,684,49.2,4479,19714,10493,9221,113.8,22449,342,85,19363,10323,9040
55139,Winnebago County,WI,170411,85855,84556,101.5,9372,9864,9721,11474,15144,22442,20144,22390,12561,10285,15050,8270,3694,38.3,35084,135327,67861,67466,100.6,156359,3874,4748,132680,66410,66270
55141,Wood County,WI,73112,35993,37119,97.0,4155,4401,4567,4084,3704,8286,8119,9727,6260,5106,8023,4470,2210,44.1,15817,57295,27971,29324,95.4,68862,513,1491,56479,27539,28940
56001,Albany County,WY,38390,19931,18459,108.0,1796,1824,1679,3238,8376,6429,3900,3123,1754,1946,2667,1203,455,27.6,6204,32186,16695,15491,107.8,34368,656,1301,30497,15886,14611
56003,Big Horn County,WY,11882,6071,5811,104.5,738,673,1022,890,523,1175,1336,1398,811,815,1421,850,230,41.6,3014,8868,4497,4371,102.9,11028,52,58,8670,4440,4230
56005,Campbell County,WY,47409,24089,23320,103.3,3640,4346,3397,2545,3069,7426,6613,5498,3725,2790,2949,1168,243,34.0,13128,34281,17611,16670,105.6,44560,170,246,33569,17109,16460
56007,Carbon County,WY,15247,8179,7068,115.7,1005,1110,871,906,903,2044,1926,1796,1226,971,1486,816,187,38.6,3564,11683,6297,5386,116.9,13919,163,165,11169,6033,5136
56009,Converse County,WY,13921,7169,6752,106.2,984,1046,829,923,625,1826,1547,1871,1100,866,1406,646,252,40.0,3468,10453,5383,5070,106.2,13308,0,32,10240,5221,5019
56011,Crook County,WY,7472,3745,3727,100.5,518,506,549,463,243,830,737,946,627,623,873,433,124,42.7,1840,5632,2861,2771,103.2,7142,10,51,5544,2806,2738
56013,Fremont County,WY,39812,20034,19778,101.3,2762,2700,3040,2503,2276,4805,4377,4587,2636,3016,4267,2280,563,38.7,10057,29755,14835,14920,99.4,28893,214,181,29573,14722,14851
56015,Goshen County,WY,13342,6789,6553,103.6,827,437,1001,830,860,1485,1441,1590,933,1060,1580,1021,277,44.1,2711,10631,5529,5102,108.4,12392,52,113,10536,5485,5051
56017,Hot Springs County,WY,4607,2312,2295,100.7,290,252,235,208,160,522,551,544,291,450,636,311,157,46.6,912,3695,1783,1912,93.3,4418,0,0,3695,1783,1912
56019,Johnson County,WY,8487,4435,4052,109.5,425,531,658,334,472,768,980,1060,652,664,1152,708,83,45.4,1873,6614,3433,3181,107.9,7938,49,0,6556,3433,3123
56021,Laramie County,WY,98320,49857,48463,102.9,6174,6698,6231,5916,6699,14775,11894,11857,6759,6043,9098,4214,1962,37.0,22755,75565,38166,37399,102.1,88215,2104,1169,73932,37510,36422
56023,Lincoln County,WY,19274,9801,9473,103.5,1337,1579,1441,1302,831,1931,2532,2213,1403,1494,2082,659,470,39.7,5235,14039,7122,6917,103.0,18468,9,54,13714,6996,6718
56025,Natrona County,WY,80333,40342,39991,100.9,5384,5213,5613,5053,4701,12140,10282,9375,5905,5087,6828,3116,1636,36.9,19388,60945,30354,30591,99.2,75689,940,473,60070,29921,30149
56027,Niobrara County,WY,2422,1091,1331,82.0,77,81,191,160,84,341,261,269,177,229,261,236,55,45.5,469,1953,857,1096,78.2,2277,14,0,1953,857,1096
56029,Park County,WY,29148,14347,14801,96.9,1552,1447,1948,1876,1563,3263,3168,3275,1796,2801,3858,1987,614,44.5,6015,23133,11266,11867,94.9,27618,198,155,22832,11223,11609
56031,Platte County,WY,8582,4531,4051,111.8,408,341,513,425,369,1021,886,1222,554,794,1172,696,181,49.2,1552,7030,3638,3392,107.3,8258,1,100,6892,3529,3363
56033,Sheridan County,WY,30140,15015,15125,99.3,1513,1618,2120,1905,1561,3598,3625,3459,2038,2536,3772,1626,769,42.3,6436,23704,11776,11928,98.7,28678,116,203,23452,11710,11742
56035,Sublette County,WY,9880,5478,4402,124.4,583,616,706,646,521,1083,1335,1253,830,549,1082,485,191,39.4,2332,7548,4185,3363,124.4,9505,0,7,7357,4049,3308
56037,Sweetwater County,WY,43521,22471,21050,106.8,3015,3613,3080,3246,2605,5913,6089,5284,2947,2757,3229,1261,482,35.3,11547,31974,16547,15427,107.3,40642,502,340,30818,15990,14828
56039,Teton County,WY,23280,12325,10955,112.5,1161,1536,1241,944,1075,4446,3761,2893,1397,1558,2137,793,338,39.3,4438,18842,9750,9092,107.2,20785,290,291,16775,8561,8214
56041,Uinta County,WY,20479,10406,10073,103.3,1498,1890,1606,1465,1056,2440,2710,2266,1710,1173,1734,631,300,35.8,5973,14506,7294,7212,101.1,19132,23,32,14041,7090,6951
56043,Washakie County,WY,8027,4065,3962,102.6,461,515,543,575,387,779,1000,940,583,551,982,525,186,42.9,1978,6049,3068,2981,102.9,7204,3,0,5997,3043,2954
56045,Weston County,WY,7049,3719,3330,111.7,393,590,258,368,353,834,855,852,429,747,768,453,149,43.1,1482,5567,2952,2615,112.9,6867,16,54,5474,2907,2567
